www.pallcare.asn.au.	A
login.commbiz.commbank.com.au.	AAAA
shop.magstore.com.au.	A
adimpact.com.au.	MX
nova937.com.au.	AAAA
www.rugsyd.com.au.	AAAA
assassin.nexon.com.au.	A
www.womensoccer.com.au.	A
aquascene.com.au.	AAAA
circavintageclothing.com.au.	A
www.crit-iq.com.au.	A
usyd.edu.au.	AAAA
www.2cutepartybags.com.au.	A
mailgatensw1.fairfax.com.au.	A
ingdirect.com.au.	AAAA
www.humansciences.mq.edu.au.	A
ingdirect.com.au.	MX
www.thecopiercompany.com.au.	AAAA
www.aro.com.au.	AAAA
www.glutenfree.com.au.	A
www.magicdust.com.au.	A
www.legislation.qld.gov.au.	AAAA
www.newstyledirect.com.au.	A
reedbusiness.com.au.	MX
www.getfoundingoogle.com.au.	AAAA
doomadgee.qld.gov.au.	A
reedbusiness.com.au.	MX
extendedvision.com.au.	A
www.planning.wa.gov.au.	AAAA
www.honeybee.com.au.	A
www.nursery.com.au.	A
www.whichfranchise.net.au.	AAAA
socialmediadaily.com.au.	A
stjeromes.wa.edu.au.	MX
wickedcampers.com.au.	AAAA
www.ingdirect.com.au.	A
ldr.newsltd.com.au.	MX
koolatsafety.com.au.	A
pegasustransfers.com.au.	MX
www.diamondcs.com.au.	A
parrotsociety.org.au.	MX
bridesdiary.com.au.	MX
southcom.com.au.	MX
www.sarahdavis.com.au.	A
www.vuu.com.au.	A
ses.library.usyd.edu.au.	A
www.colemangroup.com.au.	A
caulfield-glen-eira-leader.whereilive.com.au.	A
twf.com.au.	A
mysoul.com.au.	A
ngfarah.com.au.	MX
dodo.com.au.	MX
cadgroup.com.au.	A
congafoods.com.au.	A
nursing.edu.au.	AAAA
unsw.edu.au.	MX
www.mbaup.com.au.	A
lifespan.com.au.	MX
www.goodfoodshow.com.au.	AAAA
mx.ipera.net.au.	A
auscredits.com.au.	AAAA
rocknet.net.au.	MX
www.annemurray.net.au.	AAAA
charliebucket.com.au.	A
www.ingdirect.com.au.	AAAA
www.web-ideas.com.au.	A
aaa.com.au.	A
mail.pmdl.com.au.	A
www.allergynet.com.au.	AAAA
www.crowngroup.com.au.	A
smaart.com.au.	A
www.oilman.com.au.	A
integral.com.au.	MX
spitfire.com.au.	MX
www.uniquecarsandparts.com.au.	A
www.rsvp.com.au.	A
www.assa.edu.au.	AAAA
school.moodlemoot.com.au.	A
hotwater.build.com.au.	A
mail2.citywide.com.au.	A
southernphone.com.au.	AAAA
berkelouw.com.au.	A
selectownerscorp.com.au.	A
froggy.com.au.	MX
www.scentoflife.com.au.	A
www.moneymanagement.com.au.	A
www.lombards.com.au.	A
www.itadvocate.com.au.	AAAA
www.breakfastpointlifestyle.com.au.	A
ncoss.org.au.	AAAA
www.tenseconds.com.au.	A
tpm.com.au.	MX
www.ebgames.com.au.	A
www.ingdirect.com.au.	A
smtp.sub.net.au.	A
mailgate4.econ.usyd.edu.au.	A
rwwa.com.au.	A
wr.com.au.	MX
mail.legalaid.qld.gov.au.	A
www.allmusic.com.au.	A
www.aba.org.au.	AAAA
www.tac.vic.gov.au.	AAAA
ingdirect.com.au.	A
www.tafe.swinburne.edu.au.	A
www.cv.vic.gov.au.	A
kidsalive.com.au.	AAAA
scgi.ebay.com.au.	A
downings.com.au.	MX
adam.com.au.	MX
www.marsrecruitment.com.au.	A
mxproc.iseek.com.au.	A
www.salsas.com.au.	A
ozzi.com.au.	MX
asic.gov.au.	A
insites.com.au.	MX
www.peopleeffect.com.au.	AAAA
www.bollesafety.com.au.	A
www.unitedelectricalservices.com.au.	A
hatch.com.au.	MX
curtisbrown.com.au.	MX
acv.com.au.	AAAA
peterharveyco.com.au.	MX
amnet.net.au.	MX
www.youtravel.com.au.	A
reddog.net.au.	MX
pottery.ebay.com.au.	A
www.seek.com.au.	AAAA
www.supercuts.com.au.	A
www.cosl.com.au.	AAAA
newsltd.com.au.	MX
hibble.com.au.	MX
pu.com.au.	A
www.rsanow.com.au.	AAAA
www.betweenthelines.net.au.	A
benelli.com.au.	AAAA
motor.net.au.	A
www.solarsolar.com.au.	A
www.iriver.com.au.	A
aapt.net.au.	A
ingdirect.com.au.	AAAA
www.motorsportinsurance.com.au.	A
www.mab.com.au.	A
services.net.au.	MX
www.latinlover.com.au.	A
www.usp.com.au.	A
fujitsugeneral.com.au.	MX
frogs.org.au.	A
www.mcity.com.au.	A
www.moneymanagement.com.au.	A
i-o.net.au.	MX
www.fswshoes.com.au.	A
pacific.net.au.	MX
whk.com.au.	MX
www.ddm.org.au.	AAAA
completecolour.com.au.	A
ansonic.com.au.	A
www.ehealthcentral.com.au.	AAAA
hyperlink.net.au.	MX
www.rackitup.com.au.	A
resi.com.au.	A
maycot.com.au.	MX
www.michaelhutchence.com.au.	A
dodo.com.au.	MX
beans.net.au.	MX
www.astrology.com.au.	A
www.ingdirect.com.au.	A
davislangdon.com.au.	MX
www.rsvp.com.au.	A
www.bcreatives.com.au.	A
callista.com.au.	AAAA
www.goldenplains.com.au.	A
lhc.qld.edu.au.	AAAA
electel.com.au.	MX
www.glenroyexhaust.com.au.	AAAA
dominic.tas.edu.au.	MX
reedbusiness.com.au.	A
www.allbeauty.com.au.	A
ingdirect.com.au.	MX
giordano.com.au.	A
gardams.com.au.	AAAA
amigos.com.au.	AAAA
sbctc.com.au.	A
helen.halenet.com.au.	A
www.perthscorchers.com.au.	AAAA
jahroc.com.au.	A
mail.dodo.com.au.	A
motorcycle-insurance.com.au.	AAAA
oskar.com.au.	MX
associatedmarine.com.au.	MX
support.iprimus.com.au.	A
www.coffeeroasters.com.au.	AAAA
mhl.nsw.gov.au.	MX
www.cit.gu.edu.au.	A
dotars.gov.au.	A
www.allfourx4.com.au.	A
bel.uq.edu.au.	MX
solss.uow.edu.au.	AAAA
www.leaguehq.com.au.	AAAA
www.kieswines.com.au.	AAAA
www.accounting.unsw.edu.au.	A
28degreescard.com.au.	A
www.zodee.com.au.	AAAA
ingdirect.com.au.	A
www.scu.edu.au.	AAAA
www.nsw.gov.au.	AAAA
www.insidemma.com.au.	AAAA
argo.net.au.	MX
qldnet.com.au.	A
antiquitea.com.au.	AAAA
jmss.vic.edu.au.	MX
elders.com.au.	AAAA
townsvillebulletin.news.com.au.	AAAA
www.mcnf.com.au.	A
mail.donkyatt.com.au.	A
www.ingdirect.com.au.	AAAA
www.pokiesonline.net.au.	A
ncahs.health.gov.au.	MX
www.ingdirect.com.au.	A
permaculturewest.org.au.	A
bigpond.net.au.	A
www.4zzzfm.org.au.	A
www.arazpa.org.au.	A
accc.gov.au.	MX
unsworks.unsw.edu.au.	A
ideaworks.com.au.	MX
lifecare.org.au.	A
www.restaurantassociates.com.au.	A
sparc.net.au.	A
transport.qld.gov.au.	A
www.xxxxsummer.com.au.	A
saatchi.com.au.	MX
jaba.com.au.	MX
clockwork.com.au.	MX
www.cotedazurnelsonbay.com.au.	A
financefunding.com.au.	AAAA
mail.brockcommercial.com.au.	A
saintpatricks.nsw.edu.au.	MX
darwinexecutiveapartments.com.au.	A
www.mastershop.com.au.	A
coopers.com.au.	A
ingdirect.com.au.	MX
www.cut2shreds.com.au.	A
www.mytoshiba.com.au.	A
mailfilter.itd.uts.edu.au.	A
teaching.unsw.edu.au.	AAAA
media.hsv.com.au.	A
anao.gov.au.	A
www.honeymoonvineyard.com.au.	A
www.flaminfabrications.com.au.	A
feeds.news.com.au.	A
smtp.fishinternet.com.au.	A
mcwebs.com.au.	AAAA
asial.com.au.	AAAA
www.jetta.com.au.	AAAA
csa.gov.au.	A
cbp.com.au.	MX
www.auskey.abr.gov.au.	AAAA
www.espressohead.com.au.	AAAA
reedbusiness.com.au.	A
www.moneymanagement.com.au.	A
www.philippineholidays.com.au.	AAAA
smtp.thehub.com.au.	A
www.ebay.com.au.	A
belindajones.com.au.	MX
www.cybernamix.com.au.	A
acms.sl.nsw.gov.au.	AAAA
www.usability.com.au.	A
dailytelegraph.com.au.	AAAA
www.rsvp.com.au.	AAAA
mail.usyd.edu.au.	MX
www.surfingart.com.au.	A
www.uptheduffbook.com.au.	A
spot.com.au.	MX
www.breakfastwithaudrey.com.au.	A
www.finity.com.au.	A
www.exfoliators.com.au.	AAAA
www.sydney.edu.au.	A
www.moneymanagement.com.au.	A
www.focusbikes.com.au.	A
www.digital.org.au.	AAAA
sportsmanswarehouse.com.au.	MX
www.capitaloffice.com.au.	AAAA
mx.cs.usyd.edu.au.	A
www.ecolsoc.org.au.	AAAA
mailgate1.econ.usyd.edu.au.	A
dvrcv.org.au.	A
ftp.iinet.net.au.	AAAA
feeds.news.com.au.	A
www.kissfm.com.au.	A
spiritus.org.au.	MX
burnside.sa.gov.au.	A
iress.com.au.	MX
gate2.tech2u.com.au.	A
mail.beesafe.com.au.	A
forsterbus.com.au.	A
www.capital360.com.au.	AAAA
www.cigarworld.com.au.	A
mail01.lucas.com.au.	A
www.rowenta.com.au.	AAAA
e-wire.net.au.	MX
hollywoodnails.com.au.	AAAA
my.yahoo.com.au.	A
optushome.com.au.	A
bondigirlssurfriders.com.au.	AAAA
www.prosthodontics.com.au.	A
food.ninemsn.com.au.	A
www.deeperdays.com.au.	A
www.eet.unsw.edu.au.	AAAA
panasonic.com.au.	AAAA
connexus.com.au.	A
feeds.smh.com.au.	A
www.ecreate.com.au.	AAAA
www.trisand.com.au.	A
gisnet.net.au.	MX
www.totalimagegroup.com.au.	A
optuszoo.sportal.net.au.	A
jbeans.com.au.	AAAA
rivernet.com.au.	MX
vtown.com.au.	A
www.jaba.com.au.	A
reedbusiness.com.au.	MX
sbs.com.au.	MX
hayhouse.com.au.	AAAA
spe.publishing.uwa.edu.au.	AAAA
www.lawyers.com.au.	A
optusnet.com.au.	MX
canadabay.nsw.gov.au.	MX
www.ridemedia.com.au.	AAAA
www.jwire.com.au.	AAAA
netcon.net.au.	A
www.floorsofdistinction.com.au.	A
www.perthnow.com.au.	A
muli.com.au.	MX
datsunparts.com.au.	MX
vca.unimelb.edu.au.	A
fok.airstrip.com.au.	A
www.foxnetwork.com.au.	A
dpac.tas.gov.au.	MX
www.coralcoe.org.au.	A
smtp1.techinfo.com.au.	A
anhf.org.au.	MX
www.aracy.org.au.	A
www.australiancertified.com.au.	A
auscub.com.au.	MX
www.atp.com.au.	AAAA
cccmail.ccc.wa.gov.au.	A
sprintpeople.com.au.	AAAA
www.alumni.unsw.edu.au.	A
auski.com.au.	A
mail.melbournefinance.com.au.	AAAA
ingdirect.com.au.	AAAA
www.acyd.org.au.	AAAA
www.rtrfm.com.au.	A
www.thesocietyinc.com.au.	AAAA
www.sthelena.vic.edu.au.	A
www.ea.org.au.	A
www.mimdesign.com.au.	A
datasearch.uts.edu.au.	A
ntp.cs.mu.oz.au.	A
www.cfoweb.com.au.	AAAA
oblates.com.au.	AAAA
www.wesfarmers.com.au.	A
static2.cartoonnetwork.com.au.	A
www.preciseautocraft.com.au.	A
cellnet.com.au.	MX
www.democrats.org.au.	A
www.powermove.com.au.	A
wordconstructions.com.au.	AAAA
maild.goldcoast.qld.gov.au.	A
enc.com.au.	A
reedbusiness.com.au.	MX
www.larryscustomcycles.com.au.	A
www.aigroup.asn.au.	A
www.dbanetwork.com.au.	A
resquare.ca.	A
tcpl.ca.	A
bam.on.ca.	A
suivi.evenko.ca.	A
coxhanson.ca.	MX
www.zobo.ca.	A
spacingmontreal.ca.	A
forum.kijiji.ca.	A
igoogle.ca.	AAAA
nlh.nl.ca.	A
yahoo.ca.	MX
www.moneyville.ca.	A
unb.ca.	A
umfa.ca.	MX
mail.communityservicescouncil.ca.	A
www.davidsbridal.ca.	A
link.camelino.ca.	AAAA
picasaweb.google.ca.	AAAA
boolable.ca.	A
musica.	AAAA
rdee-ont.ca.	MX
www.espaces.ca.	AAAA
www.bathmate.ca.	A
www.bestbreakfast.ca.	A
www.lemontroyal.qc.ca.	A
www.eng.mcmaster.ca.	A
read.chcm.ubc.ca.	A
sympatico.ca.	MX
ns1.blink.ca.	AAAA
m5.eastlink.ca.	A
www.poni.ca.	A
www.brista.ca.	AAAA
anthonyyeung.ca.	A
www.bcscta.ca.	A
poolplayers.ca.	AAAA
action.web.ca.	AAAA
www.iplay.ca.	A
briarlane.ca.	A
smtp.srv.ualberta.ca.	AAAA
smtp.blink.ca.	A
nfbkids.ca.	A
www.icascanada.ca.	A
yahoo.ca.	MX
www.admissions.ualberta.ca.	A
rentcash.ca.	MX
ahsl.ca.	MX
rss.cbc.ca.	A
premiumcars.autotrader.ca.	A
bc.rentershotline.ca.	A
zeppelin.sasknet.sk.ca.	A
montreal.olx.ca.	A
ns2.yaknet.ca.	AAAA
funcampco.ca.	A
mail.dd-rd.ca.	A
gyptech.on.ca.	MX
tmmc.ca.	MX
serecon.ca.	MX
windsor.olx.ca.	AAAA
courrier.fadq.qc.ca.	A
queensu.ca.	AAAA
internetshakespeare.uvic.ca.	AAAA
www.marbleslab.ca.	A
www.stlawrencecollege.ca.	A
mx1.satelcom.qc.ca.	A
www.tobaccolabels.ca.	AAAA
ise.qc.ca.	A
www.divine.ca.	A
meg.drs.ca.	A
ns.sympatico.ca.	MX
laurierelectric.ca.	MX
mail.isure.ca.	A
mx2.bloodservices.ca.	A
www.mikeybustos.ca.	A
mx3.start.ca.	AAAA
virginradio.ca.	A
www.allaboutshoes.ca.	AAAA
citrys.ca.	A
www.givetoqueens.ca.	A
yahoo.ca.	MX
mx0.uniserve.ca.	A
www.bahai-studies.ca.	A
www.amazon.ca.	A
endirect.radio-canada.ca.	A
funcampco.ca.	MX
www.umontreal.ca.	A
coopatlantic.ca.	MX
www.amazon.ca.	A
rss.cbc.ca.	A
yeglive.ca.	A
linux.ca.	MX
mail.navcanada.ca.	AAAA
www.entreprisescanada.ca.	A
boompa.ca.	MX
videotron.ca.	A
becauseiamagirl.ca.	A
www.ratesupermarket.ca.	AAAA
people.uleth.ca.	A
ticketweb.ca.	AAAA
quarantine.royallepage.ca.	A
www.amo.qc.ca.	AAAA
sympatico.ca.	A
www.nobodycares.ca.	AAAA
fredericton.kijiji.ca.	AAAA
smtp.loyalistc.on.ca.	A
education.library.ubc.ca.	A
www.keatingstorage.ca.	A
www.fintrac.gc.ca.	A
ssms.socialsciences.uottawa.ca.	A
appleby.on.ca.	MX
www.ucs.mun.ca.	AAAA
rabble.ca.	A
tbwifi.ca.	MX
kohlander.royalroads.ca.	A
mx.lon.terago.ca.	A
coquitlam.ca.	MX
xenophile.ca.	A
www.geography.uwo.ca.	A
saskatchewan.kijiji.ca.	A
networx.on.ca.	MX
yahoo.ca.	A
ngl.ca.	MX
www.mitutoyo.ca.	A
www.tao.ca.	A
personals.sympatico.ca.	A
www.cme.med.ubc.ca.	A
mail.mcgill.ca.	AAAA
www.sq.gouv.qc.ca.	A
homes.mitula.ca.	A
mail1.augustana.ualberta.ca.	A
news.google.ca.	A
www.thecomedynetwork.ca.	AAAA
contests.sympatico.ca.	AAAA
soccer.on.ca.	MX
www.msn.yellowpages.ca.	A
www.thegatesofdawn.ca.	AAAA
live.ca.	A
hub.ebay.ca.	A
www.medicalabortion.ca.	A
sxm.quickplay.ca.	A
smtp.netscape.ca.	A
nb.sympatico.ca.	MX
outlook.bayviewglen.ca.	A
airtimeexpress.ca.	A
www.plugins.gov.on.ca.	A
techmax.ca.	AAAA
mrcbellechasse.qc.ca.	MX
gingerlove.ca.	A
aquatics.ubc.ca.	A
www.itbusiness.ca.	AAAA
www.jergensbeautifuldifference.ca.	A
is.ca.	A
evolution.ca.	MX
mx2.nci.ca.	A
videotron.ca.	MX
biology.queensu.ca.	A
www.nuclearfaq.ca.	A
yahoo.ca.	MX
fiti.ca.	MX
regina.craigslist.ca.	A
www.hvacworld.ca.	A
panasonic.ca.	MX
coolcanucks.ca.	A
citizenship.microsoft.ca.	A
barracuda.westworld.ca.	A
dace.ca.	A
zig.ca.	MX
cancer.sd35.bc.ca.	A
www.hiaa.ca.	AAAA
mail.kenora.ca.	A
crchul.ulaval.ca.	MX
relais.cegepsherbrooke.qc.ca.	A
ee.umanitoba.ca.	A
oar.nipissingu.ca.	A
lsminsurance.ca.	MX
ville.saint-eustache.qc.ca.	MX
images.realtor.ca.	AAAA
abovethefold.ca.	MX
www.classroomconnection.ca.	A
www.tourette.ca.	A
www.usuniversities.ca.	A
www.goodyear.ca.	A
learningcommons.ubc.ca.	A
passport.ca.	MX
3vis.ca.	MX
www.revetementexterieur.ca.	A
www.kellyservices.ca.	A
www.gc.ca.	AAAA
simcom.on.ca.	MX
mail2.hatch.ca.	A
mxmta.sympatico.ca.	A
seltec.ca.	A
www.yesmag.ca.	AAAA
alzheimer.ns.ca.	MX
www.makita.ca.	A
gwmailgate.gwl.ca.	A
sync.sympatico.ca.	A
beach.cc.uottawa.ca.	AAAA
cs.mcgill.ca.	A
www.voyagesinternet.ca.	A
mailgateway.firstcanadian.ca.	A
bilan.usherbrooke.ca.	A
yahoo.ca.	MX
rss.cbc.ca.	A
www.lays.ca.	A
www.cdtv.ca.	A
www.blueplanetrecycling.ca.	AAAA
rss.cbc.ca.	A
www.apheo.ca.	A
www.international.gc.ca.	A
ws.radio-canada.ca.	A
www.buyairsoft.ca.	AAAA
actra.ca.	MX
www.piac.ca.	AAAA
cog.ca.	MX
eastlink.ca.	MX
cvrd.bc.ca.	MX
www.yummymummyclub.ca.	A
www.bclaws.ca.	A
www.3minuteshorts.ca.	A
appsci.queensu.ca.	AAAA
www.ece.queensu.ca.	A
prhc.on.ca.	MX
www.montrealsauna.ca.	A
www.renison.uwaterloo.ca.	A
cfmb.ca.	MX
videotron.qc.ca.	MX
accu-rate.ca.	MX
www.cma.ca.	A
figment.ca.	MX
london.flyerland.ca.	A
sympatico.ca.	MX
swaymag.ca.	A
cementation.ca.	A
quebec.propertysold.ca.	A
blog.rockhistory.ca.	A
confederationc.on.ca.	MX
www.reelco.ca.	A
uleth.ca.	A
uahoo.ca.	A
start.ca.	A
knowledgetranslation.ca.	A
www.me.uvic.ca.	A
nlc.bc.ca.	MX
www.baystreet.ca.	A
pet-supplies.shop.ebay.ca.	AAAA
privacybydesign.ca.	A
mxyvr2.mda.ca.	A
canadaturk.ca.	MX
live.ca.	MX
lsd.uoguelph.ca.	MX
aodt.ca.	AAAA
hopkins.ab.ca.	A
yahoo.ca.	MX
primus.ca.	MX
chicken.ca.	A
www.mediawizard.ca.	AAAA
raqi.ca.	MX
www.olx.ca.	A
windsor.olx.ca.	A
mcmaster.ca.	MX
yahoo.ca.	MX
mailm.thomascookgroup.ca.	A
filter2013.zerospam.ca.	A
fbmi.ca.	MX
yahoo.ca.	MX
dfait-maeci.gc.ca.	A
netfirms.ca.	AAAA
watch.tsn.ca.	A
www.sbr.gov.bc.ca.	A
www.heraldry.ca.	A
www.excellence-earlychildhood.ca.	A
envedette.ca.	A
mxer.cis.mcmaster.ca.	A
emba.schulich.yorku.ca.	MX
gmn.ulaval.ca.	MX
www.ccts-cprst.ca.	AAAA
videotro.ca.	A
www.candevs.ca.	A
lemico.ca.	MX
mabo.ca.	A
www.alhudainstitute.ca.	A
smtp.shaw.ca.	A
www.online-casino-games.ca.	A
bstage.ca.	MX
www.termiumplus.gc.ca.	AAAA
uqar.qc.ca.	MX
www.mme.uwaterloo.ca.	A
erictam.ca.	MX
japan.apike.ca.	A
www.friends.ca.	AAAA
stylestudio.xmgames.ca.	AAAA
dofasco.ca.	A
www.drugrehab.ca.	AAAA
www.acoa-apeca.gc.ca.	A
newman.ccohs.ca.	A
sympatco.ca.	MX
brocheusesmontreal.ca.	MX
mobiletv.bell.ca.	A
scrc.umanitoba.ca.	MX
www.astronomie2009.ca.	A
rss.cbc.ca.	A
www.chem.utoronto.ca.	A
assets.wwf.ca.	A
www.nr.gov.nl.ca.	AAAA
smtpcorp2.reitmans.ca.	A
www.ntv.ca.	A
odec.ca.	A
www.phonepages.ca.	A
www.flyok.ca.	AAAA
mail1.nlh.nl.ca.	A
www.crtc.gc.ca.	A
www.usra.ca.	AAAA
www.chat-room.ca.	A
och.ca.	A
www.ajax.ca.	AAAA
mail.paulcomm.ca.	A
idcmail.shaw.ca.	A
mail.cesco.ca.	A
webmail.utoronto.ca.	A
www.smya.ca.	A
thegauntlet.ca.	MX
www.g4techtv.ca.	A
www.animextreme.ca.	A
www.expedia.ca.	A
publicite.radio-canada.ca.	A
mx2.mda.ca.	A
www.google.ca.	A
herbalmagic.ca.	A
alumni.uvic.ca.	MX
www.zoology.ubc.ca.	AAAA
www.brandonu.ca.	A
www.stages.alternatives.ca.	AAAA
www.stcatharines.ca.	A
www.ebay.ca.	A
www.cna-acj.ca.	A
encoreavenue.ca.	A
mail2.services.netscape.ca.	A
payments.ebay.ca.	AAAA
yaknet.ca.	MX
mail3.caw.ca.	A
yfile.news.yorku.ca.	A
uvlp.ca.	MX
drcareers.ca.	A
www.ebay.ca.	A
experience.hec.ca.	A
somadesign.ca.	A
w.wayground.ca.	A
penneygroup.ca.	A
mx-backup.primus.ca.	A
enel.ucalgary.ca.	MX
bellnet.ca.	MX
www.rastaonline.ca.	AAAA
bellaliant.ca.	MX
courseweb.edteched.uottawa.ca.	AAAA
www.sourceid.ca.	A
earthlyimages.ca.	A
capp.ca.	MX
vrhb.bc.ca.	MX
sympatico.ca.	MX
leg.bc.ca.	MX
future.ca.	MX
galaxybattery.ca.	A
mailsecure.oceanhost.ca.	A
www.harriskia.ca.	A
fryeblog.blog.lib.mcmaster.ca.	AAAA
www.pgc.nrcan.gc.ca.	A
theedge.ca.	MX
schneiderfoods.ca.	A
www.g8.utoronto.ca.	AAAA
www.education.gov.yk.ca.	A
brainflex.ca.	A
www.longshot.ca.	A
centraleastontario.cioc.ca.	AAAA
img1ca.trovit.ca.	A
www.dnd.ca.	A
sct.gouv.qc.ca.	MX
cw.bc.ca.	MX
scc.ca.	MX
www.finance.esg.uqam.ca.	A
town.lasalle.on.ca.	MX
www.vbce.ca.	AAAA
shaw.ca.	A
www.genzel.ca.	AAAA
www.ottawaartgallery.ca.	A
ercb.ca.	MX
reader.metronews.ca.	A
cdn.media.yp.ca.	A
tec4.ca.	MX
www.math.unb.ca.	A
www.hrandequity.utoronto.ca.	A
aspect.bc.ca.	MX
www.library.ubc.ca.	A
barracuda.edu.yorku.ca.	A
solariumdeparis.ca.	MX
www.scene.ca.	AAAA
www.nsi-canada.ca.	A
www.opp.ca.	A
arenacross.ca.	A
tumblr.ryancoleman.ca.	A
america.	A
canada.gc.ca.	AAAA
rss.cbc.ca.	A
www.ngnews.ca.	A
chl.ca.	A
www.ugrad.cs.ubc.ca.	A
vur.ca.	A
concours.sympatico.ca.	A
monstertemplate.ca.	A
smtpin.eastlink.ca.	A
www.pwc.k12.nf.ca.	AAAA
hrrh.on.ca.	MX
inside.eciad.ca.	A
service.ipont.ca.	AAAA
www.stormy.ca.	A
mail1.gov.yk.ca.	A
www.villanova.k12.nf.ca.	A
smtp1.fcl.ca.	A
mail.web.ca.	A
www.getcracking.ca.	A
mail.mdpinchercreek.ab.ca.	A
pubs.casi.ca.	A
mx0.ntl.sympatico.ca.	A
whughes.ca.	MX
mobilexchange.ca.	MX
smtp.mie.utoronto.ca.	A
www.careerowl.ca.	A
uoguelph.ca.	A
www.russianwoman.ca.	AAAA
www.design-writer.ca.	A
www.math.uwaterloo.ca.	AAAA
shaw.ca.	MX
cira.ca.	MX
eba.ca.	MX
ns1.nbc.netcom.ca.	A
www.quebecairport.ca.	A
www.teamradio.ca.	A
www.dancotrans.ca.	AAAA
gamemaster.qc.ca.	MX
krismer.ca.	MX
logicielseducatifs.qc.ca.	A
dmr.ca.	MX
yahoo.ca.	MX
lightingsolutions.ca.	A
www.cegep-ste-foy.qc.ca.	A
cgocable.ca.	MX
sympatico.ca.	MX
www.myheartbeatsto.ca.	A
www.ualberta.ca.	A
www.myconcordia.ca.	A
www.gov.pe.ca.	AAAA
bnc.ca.	A
thecurtisparadisshow.ca.	AAAA
www.educaloi.qc.ca.	A
accnet.ca.	A
www.mercedes-benz.ca.	A
videotron.smartfind.ca.	A
maps.google.ca.	A
lemico.ca.	A
mail.avanti.ca.	AAAA
yellowknife.craigslist.ca.	A
live.ca.	MX
www.crossfit.ca.	AAAA
jobsearch.monster.ca.	A
shaw.ca.	MX
www.ili.ca.	A
www.commissionaires.ca.	A
mail2.comfo.ca.	A
www.hellomagazine.ca.	A
www.azevedo.ca.	A
weatheroffice.ec.gc.ca.	A
mail.megacomputers.ca.	A
mcg.ca.	A
groups.google.ca.	A
cabsys.ca.	MX
statcan.ca.	MX
www.gopad.ca.	A
stylusgroup.ca.	A
www.elsevier.ca.	A
www.regions.cadets.forces.gc.ca.	A
imsgroup.ca.	A
mail.monisys.ca.	A
sympatico.ca.	MX
molbiol-tools.ca.	A
gwg.on.ca.	MX
recit.qc.ca.	A
tpi.ca.	MX
smtp2.lawtons.ca.	A
www.ischool.utoronto.ca.	A
alc.ca.	A
triathlonmagazine.ca.	A
eos.ubc.ca.	MX
isp.ca.	MX
www.loansequity.ca.	A
www.moneysense.ca.	AAAA
metrics.ebgames.ca.	A
noblegrape.ca.	MX
helpdesk.uvic.ca.	A
cars.mitula.ca.	A
babycenter.ca.	A
www.jcomtesexo.ca.	A
www.ccc.ca.	A
gosympatico.ca.	MX
solarsea.ca.	A
rrsss16.gouv.qc.ca.	MX
www.saplings.ca.	A
ruralconnection.ca.	MX
gfsinc.ca.	A
www.iposgoode.ca.	A
library.utoronto.ca.	MX
nat.babytel.ca.	A
www.ece.ubc.ca.	A
www.globalia.ca.	A
www.teachandlearn.ca.	AAAA
rcmp.grc.ca.	MX
wcb.pe.ca.	MX
publicesmapplicant.ontariocolleges.ca.	A
www.stclaircollege.ca.	A
collegeahuntsic.qc.ca.	A
www.concordia.ca.	A
asf.ca.	A
saskatoon.en.craigslist.ca.	A
www.canadahaitiaction.ca.	A
csharricana.qc.ca.	MX
nugget.ca.	MX
crazytech.ca.	A
yahoo.ca.	A
rtm.ebay.ca.	AAAA
www.ehmac.ca.	AAAA
csai.ca.	A
www.smithmusic.ca.	AAAA
laptoprepair.ca.	A
www.immigrantservicescalgary.ca.	AAAA
iamyoga.ca.	A
iiroc.ca.	MX
www.csd.uwo.ca.	A
www.e-tech.ca.	A
mixes.dabears.ca.	AAAA
hydro.qc.ca.	MX
prdcg4ipta02x-ext.shaw.ca.	A
harriet.tubman1.yorku.ca.	AAAA
banweb.mcgill.ca.	A
www.roadsideattractions.ca.	AAAA
durhamc.on.ca.	MX
www.tupperware.ca.	A
www.ricko.ca.	A
spam-scan2.skycomp.ca.	A
www.cityandcolour.ca.	A
www.equestre.ca.	A
www.bcdc.ca.	A
fwmail02.sickkids.ca.	A
www.hp.ca.	A
fin.gc.ca.	A
jmvalin.ca.	A
mail.docuweb.ca.	A
www.embamcgillhec.ca.	A
myrru.royalroads.ca.	A
www.coffeetime.ca.	A
www.bizop.ca.	A
yourhome.ca.	MX
easternwireless.ca.	MX
mail01.ghsd75.ca.	A
bundle.bell.ca.	A
swa.ca.	MX
www.arbonne.ca.	AAAA
www.scf.gouv.qc.ca.	A
www.cas.mcmaster.ca.	AAAA
smtp.figment.ca.	A
yahoo.ca.	MX
www.g4s.ca.	A
jazzforest.ca.	A
www.sceneandheard.ca.	AAAA
weirdscience.ca.	A
whitehorse.sgt.qc.ca.	A
garfield.cs.mun.ca.	A
pinpin.iro.umontreal.ca.	A
sympatico.ca.	MX
ns02.cira.ca.	A
www.agco.on.ca.	A
mail2.cw.bc.ca.	AAAA
me2u.ca.	MX
cas.ucalgary.ca.	A
www.cips.ca.	A
mabprofil.qc.ca.	A
westman.wave.ca.	MX
www.vieux.montreal.qc.ca.	A
francais.concordia.ca.	A
earthday.ca.	A
mail.vovan.ca.	A
culture.alberta.ca.	AAAA
www.tripadvisor.ca.	A
www.trainyard.ca.	AAAA
citycoredevelopments.ca.	A
mail2.theupsstore.ca.	A
dline.ca.	MX
bordertowndesignjam.eventbrite.ca.	AAAA
dugan.ca.	A
csd.uwo.ca.	MX
www.droitauteur.gouv.qc.ca.	AAAA
barracuda.scdsb.edu.on.ca.	A
digital.library.mcgill.ca.	AAAA
www.tibet.ca.	A
stats.canadapost.ca.	A
acciona.ca.	MX
mar.dfo-mpo.gc.ca.	MX
utoronto.ca.	MX
www.ipanda.ca.	A
www.iapa.ca.	A
hauser.ca.	A
www.tc.gc.ca.	A
shaw.ca.	MX
www.history.uottawa.ca.	A
fslactivities.ca.	A
www.iglesia.ca.	A
engmail.uwaterloo.ca.	A
www.morningstar.ca.	A
shop.aol.ca.	A
homesnanaimo.ca.	MX
wfgmail.ca.	MX
www.s3hr.ca.	A
truckmasters.ca.	MX
www.intuitwebsites.ca.	A
thumbs2.ebaystatic.com.	AAAA
mountaineerpublishing.com.	MX
www.mediafire.com.	A
www.freemarket.com.	A
google.com.	A
developers.facebook.com.	A
ads.smowtion.com.	A
solofarandulaperu.blogspot.com.	A
m.addthisedge.com.	A
ssl.google-analytics.com.	A
www.reuters.com.	A
mail.sodoit.com.	A
www.download.windowsupdate.com.	A
csi.gstatic.com.	A
www.apple.com.	A
www.haacked.com.	A
www.jujiaow.com.	A
api.facebook.com.	A
dns.msftncsi.com.	A
sageinc.com.	A
google.com.	A
developers.facebook.com.	A
api.twitter.com.	A
pub.reggaefrance.com.	A
an.d.chango.com.	A
www.gossiponthis.com.	AAAA
mail.mastertex.com.	A
www.foxsportsla.com.	A
education.idoneos.com.	AAAA
api.twitter.com.	A
developers.facebook.com.	A
i2.ytimg.com.	A
edge.quantserve.com.	A
hi-in.facebook.com.	A
www.facebook.com.	A
es-es.facebook.com.	A
quakerfabric.com.	MX
es-es.facebook.com.	A
andrewsullivan.com.	MX
i499.photobucket.com.	A
www.hotelelreymoro.com.	A
www.microsoft.com.	A
www.gonelocal.com.	A
rad.msn.com.	A
img.apnanalytics.com.	A
apps.facebook.com.	A
www.shareyouritems.com.	A
www.man-engines.com.	AAAA
nothirst.com.	A
asktoolbar.weather.com.	A
img.youtube.com.	A
www.facebook.com.	A
s1.wp.com.	A
s.youtube.com.	A
gma.yahoo.com.	A
lh3.ggpht.com.	A
fistintheair.com.	A
hackingetico.com.	AAAA
static.xvideos.com.	A
blog.mobango.com.	A
st.chatango.com.	A
marketingdesdelaromana.blogspot.com.	A
www.juegospara.com.	A
toolbarqueries.google.com.	A
chinamoly.com.	MX
different-love.foroactivo.com.	A
data-recovery-free-help.blogspot.com.	A
darkanime.mforos.com.	AAAA
i2.ytimg.com.	AAAA
dmse.com.	MX
mediacdn.disqus.com.	A
laplumadebarro.blogspot.com.	A
www.google.com.	A
client66.dropbox.com.	A
t2.gstatic.com.	A
cdn.mediafire.com.	A
tsuki-yaoi.blogspot.com.	A
imap.gmail.com.	A
mychemhelena.obolog.com.	A
www.humorpower.com.	A
eu4.stvid.com.	A
www.ct-7ob.com.	A
video.xnxx.com.	A
ssl.gstatic.com.	A
www.cinemanow.com.	A
developers.facebook.com.	A
butovo.com.	A
www.birdseye.com.	A
abajate.blogspot.com.	A
www.blackberry.com.	A
ib.adnxs.com.	A
email.com.	MX
www.facebook.com.	A
mt1.googleapis.com.	A
l.yimg.com.	A
t7.tagstat.com.	A
ucs.query.yahoo.com.	A
i4.ytimg.com.	A
rylandhomes.com.	MX
google.com.	A
sfdr-cisd.com.	MX
goodereader.disqus.com.	A
1496354998.mail.outlook.com.	A
landrover.tagworldwide.com.	A
i4.ytimg.com.	A
download884.avast.com.	A
hi-in.facebook.com.	A
translate.google.com.	A
www.google.com.	A
tpc.googlesyndication.com.	A
blog.seattlecoffeegear.com.	AAAA
noticias.lainformacion.com.	A
www.facebook.com.	A
descargararesgratis.disqus.com.	A
redirector.c.youtube.com.	A
i366.photobucket.com.	A
api-read.facebook.com.	A
docs.google.com.	A
m.addthisedge.com.	A
img.mediaplex.com.	A
login.live.com.	A
afrozeprinting.com.	A
youtube-ui.l.google.com.	MX
apps.facebook.com.	A
www.google.com.	A
sponsoredcdn.speedbit.com.	AAAA
www.xn--cabaasmazamitla-1qb.com.	A
developers.facebook.com.	A
idealcalor.com.	MX
clients1.google.com.	A
a355.phobos.apple.com.	A
mail2lucky.com.	MX
www.facebook.com.	A
api.twitter.com.	A
el.y8.com.	A
dlpiper.com.	MX
canadianislamiccongress.com.	A
gmaseven.blogspot.com.	AAAA
tijuana-kei.com.	A
www.reverbnation.com.	A
i3.ytimg.com.	A
www.fotosrarasgratis.com.	A
enblogs.com.	A
g.ceipmsn.com.	A
suggestqueries.google.com.	A
www.msftncsi.com.	AAAA
api.facebook.com.	A
liduvinacarrera.blogspot.com.	A
encrypted-tbn1.google.com.	A
need2bfit.com.	A
www.iegallery.com.	A
googlehosted.l.googleusercontent.com.	MX
www.youtube.com.	A
view.atdmt.com.	A
mail.landbank.com.	A
cuda.csystems.com.	A
mail.kwreferred.com.	A
www.google.com.	A
www.macgeneration.com.	A
www.youngcloseup.com.	AAAA
www.youtube.com.	A
c0551612.cdn.cloudfiles.rackspacecloud.com.	A
safebrowsing-cache.google.com.	A
www.facebook.com.	A
xodusgroup.com.	MX
www.winamp.com.	A
www.facebook.com.	A
images03.olx-st.com.	A
theflatland.com.	A
www.mmaaxx.com.	A
gswebhost.com.	A
r1rk9np7bpcsfoeekl0khkd2juj27q3o-a-fc-opensocial.googleusercontent.com.	A
s3.amazonaws.com.	A
www.google.com.	A
css.wlxrs.com.	A
audio-sv5-t1-1.pandora.com.	AAAA
www.facebook.com.	A
www.swtorguidehq.com.	A
www.youtube.com.	A
blog.gypsy05.com.	A
u20.eset.com.	A
a1007.w43.akamai.net.	MX
a.root-servers.net.	A
a995.mm1.akamai.net.	A
a.root-servers.net.	A
a.root-servers.net.	A
washeen91.writingjob.hop.clickbank.net.	A
a.root-servers.net.	A
a.root-servers.net.	A
a.root-servers.net.	A
a.root-servers.net.	A
a.root-servers.net.	A
connect.facebook.net.	A
a.root-servers.net.	A
a.root-servers.net.	A
www.difasa.net.	A
mindspring.net.	MX
a.root-servers.net.	A
host1.dia.net.	MX
a.root-servers.net.	A
s1-excel.vo.msecnd.net.	A
www.bridedressup.net.	A
a.root-servers.net.	A
a.root-servers.net.	A
a.root-servers.net.	A
a771.da1.akamai.net.	A
zynga2-a.akamaihd.net.	A
a.root-servers.net.	A
sp.cwfservice.net.	A
a.root-servers.net.	A
msnportal.112.2o7.net.	A
a.root-servers.net.	A
a.root-servers.net.	A
a.root-servers.net.	A
a.root-servers.net.	A
a995.mm1.akamai.net.	A
www.gayteacher.net.	A
petsafe.net.inbound15.mxlogicmx.net.	A
a.root-servers.net.	A
a.root-servers.net.	A
sp.cwfservice.net.	A
a.root-servers.net.	A
a.root-servers.net.	A
a.root-servers.net.	A
fbcdn-profile-a.akamaihd.net.	A
a.root-servers.net.	A
mail.marstu.net.	A
a.root-servers.net.	A
d1.media.v4.skyrock.net.	AAAA
csc.beap.ad.yieldmanager.net.	A
quitarverrugasylunares.net.	A
e24.tns-cs.net.	AAAA
a.root-servers.net.	A
a.root-servers.net.	A
a.root-servers.net.	A
secure.shared.live.com.edgekey.net.	AAAA
auth.np.ac.playstation.net.	A
fbcdn-profile-a.akamaihd.net.	A
a.root-servers.net.	A
s3pr.shoptowin.net.	A
a1108.da1.akamai.net.	A
magaltc.com.inbound15.mxlogic.net.	A
metrics.el-mundo.net.	A
www.hasrawy.net.	A
www.mapp-oea.net.	AAAA
a.root-servers.net.	A
sp.cwfservice.net.	A
rehbaum.net.	MX
d2n8p8eh14pae1.cloudfront.net.	A
a.root-servers.net.	A
a.root-servers.net.	A
connect.facebook.net.	A
a.root-servers.net.	A
a4.da1.akamai.net.	A
ads2.msads.net.	A
a.root-servers.net.	A
sn18.mailshell.net.	A
www.sexomax.net.	A
content.yieldmanager.edgesuite.net.	A
a.root-servers.net.	A
a.root-servers.net.	A
a.root-servers.net.	A
al-nabaa.net.	MX
ocsp.entrust.net.	A
a.root-servers.net.	A
aaugonline.net.	MX
mail.globalinetbiz.net.	A
a.root-servers.net.	A
www.providencenightlife.net.	A
clock.fmt.he.net.	A
a.root-servers.net.	A
googleads.g.doubleclick.net.	A
a1052.g.akamai.net.	A
bogotaku.mejorforo.net.	A
d18txuuu339yuz.cloudfront.net.	A
cn1.redswoosh.akadns.net.	A
a.root-servers.net.	A
e461.b.akamaiedge.net.	AAAA
a.root-servers.net.	A
mobilesources.net.	A
a.root-servers.net.	A
a.root-servers.net.	A
sertel2k.vtrbandaancha.net.	AAAA
a.root-servers.net.	A
a.root-servers.net.	A
a.root-servers.net.	A
ad.doubleclick.net.	A
www.manhunt.net.	A
www.takethewalk.net.	A
ns2.dnspod.net.	A
a.root-servers.net.	A
www.amateurs-videos.net.	A
a1005.w42.akamai.net.	A
i.t-mobile-favourites.net.	AAAA
a.root-servers.net.	A
r.openx.net.	A
fbcdn-profile-a.akamaihd.net.	A
a.root-servers.net.	A
ci.national-city.ca.us.inbound15.mxlogic.net.	A
a.root-servers.net.	A
a1132.da1.akamai.net.	A
a.root-servers.net.	A
a.root-servers.net.	A
wilsontechnologies.net.inbound15.mxlogicmx.net.	A
a.root-servers.net.	A
zynga2-a.akamaihd.net.	MX
a.root-servers.net.	A
a.root-servers.net.	A
a.root-servers.net.	A
www.taringa.net.	A
a998.mm1.akamai.net.	A
pubads.g.doubleclick.net.	A
meneame.net.	A
obbit.net.	MX
sp.cwfservice.net.	A
dsn6.d.skype.net.	MX
me.effectivemeasure.net.	A
a.root-servers.net.	A
a.root-servers.net.	A
update.batterycare.net.	A
coleman-bh.com.inbound15.mxlogic.net.	A
fbcdn-profile-a.akamaihd.net.	A
tags.w55c.net.	A
a.root-servers.net.	A
googleads.g.doubleclick.net.	MX
mx1.okehosting.net.	A
www.upwallpapers.net.	AAAA
gocsg.net.	MX
laidesigngroup.com.inbound15.mxlogic.net.	A
dvd-decrypter.programas-gratis.net.	A
escookie.mystarworld.net.	AAAA
d1r9j5rytlayy8.cloudfront.net.	A
connect.facebook.net.	A
connect.facebook.net.	A
gates.shapeservices.net.	A
smtp.iwaynet.net.	A
ad-g.doubleclick.net.	A
a1332.g.akamai.net.	A
s0.2mdn.net.	A
sp.cwfservice.net.	A
www9.effectivemeasure.net.	A
index.rpg.net.	AAAA
a1490.g.akamai.net.	A
a.root-servers.net.	A
bellsouthpwp.net.	A
a.root-servers.net.	A
d3ojfab0q2dwum.cloudfront.net.	AAAA
a.root-servers.net.	A
ad-g.doubleclick.net.	A
a.root-servers.net.	A
www.nolimitweb.nl.	A
ch.tudelft.nl.	MX
www.huishoudbeurs.nl.	A
secon.nl.	MX
broekhuisjuweliers.nl.	A
site.delain.nl.	A
cmgtcontent.ahold.com.kpnis.nl.	A
broekhuisjuweliers.nl.	A
dwiex402.mumc.nl.	A
mx.easynet.nl.	AAAA
ns2.otys.nl.	A
www.deltares.nl.	A
news.google.nl.	A
mail.kiwa.nl.	A
www.allposters.nl.	A
winkel.vpro.nl.	AAAA
mx2.glr.nl.	A
mail.edu.rocmn.nl.	A
tfgrtezqnfkewpchzgyronljweoyop.nl.	AAAA
casema.nl.	MX
gmt.nl.	MX
lvs.fok.nl.	A
mx99.elive.nl.	A
www.pharmaton.nl.	A
www.animewolken.nl.	A
feyenoord.headliner.nl.	A
annettevandenbosch.nl.	MX
www.wetenschapsforum.nl.	A
ns02.nexthost.nl.	A
www.sega.nl.	AAAA
beko-zuid.nl.	MX
dingenvanlia.nl.	A
mail.knijnenburgbeheer.nl.	A
www.oxfamnovibpaktuit.nl.	A
www.ford.nl.	A
www.twenga.nl.	A
shadow.mature.nl.	AAAA
www.four05.nl.	A
www.zvdk.nl.	A
dailycappuccino.nl.	AAAA
www.minilening.nl.	A
decollage.nl.	A
www2.animalsexfilms.nl.	A
stewie.wojas.nl.	A
www.blend.nl.	A
925.nl.	MX
www.mdf.nl.	A
www.saartjeknits.nl.	A
dordrecht.nl.	MX
www.dokterdokter.nl.	A
static.depers.nl.	AAAA
www.stealth.nl.	AAAA
ns2.redbee.nl.	A
www.yourskin.nl.	AAAA
www.gamert.nl.	AAAA
newsletter.iciparisxl.nl.	AAAA
www.popinstituut.nl.	A
www.andrevanamstel.nl.	A
www.wikipedia.nl.	A
www.endandit.nl.	A
netmail.hetnet.nl.	A
hetnet.nl.	MX
www.rexona.nl.	A
quicknet.nl.	MX
www.winrar.nl.	A
alternative-music.nl.	A
dyom.gtagames.nl.	AAAA
broekhuisjuweliers.nl.	A
www.stalparadiso.nl.	A
dutchleader.nl.	A
www.clive.nl.	AAAA
www.sp.nl.	A
www.badblog.nl.	A
chtig.nl.	MX
www.macworld.nl.	A
mail.cms-mail.nl.	A
www.prijsvergelijk.nl.	A
gwebcache.linuxonly.nl.	A
ns3.widexs.nl.	A
sanko.nl.	AAAA
mx2.schonemail.nl.	A
www.dse.nl.	AAAA
video.startpagina.nl.	A
dakvanbrabant.nl.	MX
www.shifta.nl.	A
ipc-bv.nl.	A
unimills.nl.	MX
gevudo.nl.	A
spel.nl.	MX
www.free-d.nl.	A
dropship.ortec.nl.	A
alyssa.knuffelt.nl.	AAAA
www.goastro.nl.	A
www.cinema.nl.	A
retro.nrc.nl.	A
mcleodsfans.weblog.nl.	AAAA
www.keds.nl.	A
mx2.spamvrijwerken.nl.	A
mail2.tmn.nl.	A
www.mijnwoordenboek.nl.	A
www.gladiatus.nl.	A
sloendregt.nl.	A
www.kpnvandaag.nl.	A
www.feestkleding365.nl.	A
www.pern.nl.	A
www.oxilion.nl.	AAAA
annettevandenbosch.nl.	A
www.rnw.nl.	A
adformatie.nl.	MX
www.digitalage.nl.	A
www.myfreefarm.nl.	AAAA
www.lighting.philips.nl.	A
mx1.vpo.nl.	A
dagaanbieding.conrad.nl.	A
roez.groningen.nl.	MX
www.zwangerschapspagina.nl.	A
riagg-maastricht.nl.	MX
www.hilversumbest.nl.	AAAA
www.math.ru.nl.	A
computertotaal.nl.	A
berkel.nl.	MX
mail2.t-systems.nl.	A
www.telegraaf.nl.	A
wetenschap.blog.nl.	A
broekhuisjuweliers.nl.	A
noxpeople.nl.	MX
straatklus.nl.	MX
degeus.nl.	MX
ns2.helderhosting.nl.	A
www.informarn.nl.	A
www.duurzame-energieshop.nl.	A
onlinegames.startpagina.nl.	A
bluefish.openoffice.nl.	A
capelleaandenijssel.nl.	MX
www.interglot.nl.	A
mx1.010.vpo.nl.	A
kroonweb.nl.	MX
www.sexchat.nl.	A
csimg.koopkeus.nl.	A
www.thisistheend.nl.	A
www.maxx-xs.nl.	A
www.spelstad.nl.	A
925.nl.	A
straatklus.nl.	A
l1b.nl.	AAAA
content.motomedia.nl.	AAAA
www.expedia.nl.	A
www.tboek.nl.	AAAA
membolle.demon.nl.	MX
www.linkspeurder.nl.	A
broekhuisjuweliers.nl.	A
alviss.et.tudelft.nl.	A
condorcet.nl.	MX
www.bispublishers.nl.	A
www.hypex.nl.	A
icy.rtl.nl.	AAAA
mail01.gilissen.nl.	A
www.google.nl.	A
helenpark.nl.	MX
mijn.ing.nl.	A
mpi.nl.	MX
bertrik.sikken.nl.	A
www.move.vu.nl.	A
vip2.clickzzs.nl.	A
versatel.nl.	A
industrie.blog.nl.	A
hta.nl.	MX
denhaag.nl.	MX
live.nl.	MX
www.ljil.leidenuniv.nl.	AAAA
fiets.nl.	MX
assuweb.nl.	A
mail.kingsquare.nl.	MX
www.han.nl.	A
www.compuclub.nl.	A
www.logismarket.nl.	A
telfort.nl.	A
srv1.flexfilter.nl.	A
mail.millford.nl.	A
www.cestdubo.nl.	A
bit.nl.	MX
xs4all.nl.	A
mail.cazemierparket.nl.	A
resources2.kb.nl.	A
www.westonline.nl.	A
www.topfunny.nl.	A
www.chateauhotels.nl.	A
ihs.nl.	MX
mail2.blackbox.nl.	A
hyconcar.nl.	MX
huig.nl.	A
www.radio1.nl.	AAAA
www.caiway.nl.	A
verbrugge.nl.	MX
baracuda1.balans.nl.	A
www.zie.nl.	AAAA
www.oma.nl.	AAAA
broekhuisjuweliers.nl.	A
hetnet.nl.	MX
ns1.in2ip.nl.	A
d57d320a.static.ziggozakelijk.nl.	A
jbteens.messageboard.nl.	A
www.google.nl.	A
casema.nl.	A
www.hanglos.nl.	A
www.girlsgogames.nl.	A
www.sbs6.nl.	AAAA
www.budgetair.nl.	A
tiscali.nl.	MX
ns1.dbn.nforce.nl.	A
projecten.elitech.nl.	AAAA
lifestyle.overzicht.nl.	A
tros.dmd.omroep.nl.	AAAA
www.codarts.nl.	A
www.virtualvillage.nl.	A
server-09.stream-server.nl.	A
www.vk.nl.	A
joostlangeveldorigami.nl.	A
www.jumbo-apps.nl.	A
www1.fee.uva.nl.	A
sra.nl.	MX
images.weserv.nl.	A
news.google.nl.	A
mailbizz02.bizztravel.nl.	A
forum.viva.nl.	A
gbweb02.gamebasics.nl.	A
www.nosop3.nl.	A
www.nieuwemobiel.nl.	AAAA
www.shootr.nl.	A
mx.roadrunnerrecords.nl.	A
broekhuisjuweliers.nl.	A
images.m4.mailplus.nl.	A
nccw-casa.nl.	A
rc.bt.ilsemedia.nl.	A
feeds.depers.nl.	A
www.tivoli.nl.	A
panta-holdings.nl.	MX
cartoonmovement.spreadshirt.nl.	A
tvatm.nl.	MX
mx1.opendomein.nl.	A
www.rnw.nl.	A
broekhuisjuweliers.nl.	A
www.amsterdammarathon.nl.	A
www.wass.wur.nl.	A
opera.mirror.triple-it.nl.	A
news.google.nl.	A
octrooibureau.nl.	MX
www.agoda.nl.	A
minbuza.nl.	AAAA
www.nps.nl.	A
www.tuning-gids.nl.	A
www.digimon-paradijs.nl.	A
biomet.nl.	MX
www.hetutrechtsarchief.nl.	A
broekhuisjuweliers.nl.	A
www.vliegwinkel.nl.	A
www.compuclub.nl.	AAAA
www.dagelijksestandaard.nl.	A
toolbarqueries.google.nl.	AAAA
mededelingen.marktplaats.nl.	A
www.derecensent.nl.	A
www.brokertarieven.nl.	AAAA
mx1.mail.omroep.nl.	A
ii.nl.	A
www.allegoededoelen.nl.	A
wur.nl.	A
aspmail2.atinet.nl.	A
software.startpagina.nl.	AAAA
tebenet.nl.	A
www2.eur.nl.	A
www.denieuwereporter.nl.	A
www.soepvork.nl.	A
www.yahoo.nl.	AAAA
www.rtvnoord.nl.	AAAA
pelxrelay02.pelican-ict.nl.	A
centraalbeheer.nl.	A
akd.nl.	MX
undutchables.nl.	MX
www.overgrow-italy.nl.	A
stream01.platform02.true.nl.	A
broekhuisjuweliers.nl.	A
bmc.nl.	MX
avensus.nl.	MX
hag.nl.	MX
www.elcheapo.nl.	A
imail.nl.	A
www.itc.nl.	A
fieldtrip.fcdonders.nl.	A
www.noord-holland.nl.	A
home.nl.	MX
www.reddotcommerce.nl.	A
www.wegenermediaadverteren.nl.	A
oma.nl.	MX
ns2.hostnetbv.nl.	AAAA
nieuwe.startpagina.nl.	A
fallback.vivent.nl.	A
mx.mailfilter.ict-concept.nl.	A
news.google.nl.	A
www.agoda.nl.	A
www.fd.nl.	A
mannen.islive.nl.	A
schaatsen.blog.nl.	A
pilkingtons.nl.	MX
candea.nl.	MX
www.checkitout.nl.	AAAA
pop3.upcmail.nl.	A
www.nihes.nl.	A
fallback-datacenter.tccresearch.nl.	A
www.lammertbies.nl.	A
fulcofinancien.nl.	MX
www.watermeloncat.nl.	A
www.kaart.nl.	AAAA
www.hetnet.nl.	AAAA
nwo.nl.	MX
mail.upcmail.nl.	A
www.moviemachine.nl.	A
www.nieuwamsterdam.nl.	A
www.mozbrowser.nl.	AAAA
www.petervanderwoude.nl.	AAAA
mail.arboned.nl.	A
linedancing.nl.	MX
windows.nl.	A
tele2.nl.	AAAA
roczeeland.nl.	MX
ns1.bedrijvenweb.nl.	A
www.justanothernerd.nl.	AAAA
quote.nl.	MX
www.tienersexfilms.nl.	A
ns3.siteview.nl.	AAAA
syner3.nl.	MX
www.velvetmusic.nl.	AAAA
diginotar.nl.	A
www.crimelab.nl.	A
www.iscra.nl.	AAAA
uni-one.nl.	MX
mail.rdq.nl.	A
xzibit.nl.	MX
mx02.foxxl.nl.	A
www.hku.nl.	A
wits.nl.	MX
radio6presents.radio6.nl.	A
mail20.ing.nl.	A
static.gos2m.nl.	A
home.nl.	MX
www.fon.hum.uva.nl.	A
reflector.kpnstreaming.nl.	A
peterned.home.xs4all.nl.	A
www.trendwerk.nl.	A
www.psx-sense.nl.	A
creditsmedia.nl.	A
www.nintendo.nl.	AAAA
greenhouseseeds.nl.	A
www.gooddayz.nl.	A
moremix.hyves.nl.	A
sensire.nl.	MX
counterpart.nl.	A
www.151617.nl.	A
content50c2a.omroep.nl.	AAAA
content1c.omroep.nl.	AAAA
www.xmissymovies.nl.	A
www.ibuildings.nl.	AAAA
www.waarmaarraar.nl.	A
bliksem.startpagina.nl.	A
be-creative.nl.	A
www.remax.nl.	A
pzc.nl.	MX
fme.nl.	MX
www.uitzendbureau.nl.	A
ish.nl.	MX
www.omroplive.nl.	A
www.wereldoorlog1418.nl.	A
pgp.surfnet.nl.	AAAA
www.niveaformen.nl.	A
