www.norther.net.	A
dapelectric.com.inbound10.mxlogic.net.	A
www.nodo50.net.	A
www.thecyprusguide.net.	A
www.gameqq.net.	A
fini.lacoctelera.net.	A
2183.net46.net.	A
ct.duba.net.	A
mailhost.f-ten.net.	A
sello-maligno.lacoctelera.net.	A
aetn.com.112.2o7.net.	AAAA
inbound.lb3enterprises.com.netsolmail.net.	A
abtechsys.com.inbound10.mxlogic.net.	AAAA
nest.net.	A
imashun-navi.seesaa.net.	AAAA
bibliocd.6te.net.	AAAA
finansistov.net.	A
mail.jayreese.net.	A
forotextil.foroslatinos.net.	A
i.gtld-servers.net.	A
www.f-o-a.net.	AAAA
pro-evolution-soccer-6.programas-gratis.net.	A
confrariacedeira.lacoctelera.net.	A
www.archivomagon.net.	A
www.travelsur.net.	AAAA
relay2.merula.net.	A
barcalounger.com.mx4.musfiber.rcimx.net.	A
www.bc4.net.	A
laundromatic.net.	MX
protect.blackberry.com.edgekey.net.	A
vesper.net.	A
yaggy.com.inbound15.mxlogicmx.net.	A
thomasthetrain.net.	A
images.eurogamer.net.	A
eaarthlink.net.	A
d37akznbo35tvu.cloudfront.net.	AAAA
im3-tub-ua.yandex.net.	A
hnabooks.com.inbound15.mxlogicmx.net.	A
loneagle.net.	A
ellingtonschools.net.	MX
ns2.framecom.net.	AAAA
mail.webkraft.net.	A
kakaroto.homelinux.net.	A
zdns2.cu99.net.	A
www.genmx.net.	AAAA
d10noqxa27gsee.cloudfront.net.	AAAA
westernindian.net.	MX
tracker.lzbt.net.	A
e1957.b.akamaiedge.net.	A
cfile258.uf.daum.net.	A
www.fencing.net.	A
consoldated.net.	MX
a467.g.akamai.net.	AAAA
lisd.net.	MX
nationalrealty.com.inbound15.mxlogic.net.	A
mail.zoobuy.net.	A
mail.rhodes-alumni.net.	A
inbound.mti-milliren.com.netsolmail.net.	A
adtrack.com.inbound15.mxlogicmx.net.	A
pokergratis.net.	AAAA
suddenilnk.net.	MX
femflex.net.	A
2mx.integra.net.	A
home.emfo01.net.	AAAA
show-me.net.	MX
onecall.tt.omtrdc.net.	A
cjbna.com.inbound35.mxlogic.net.	A
lsm.net.	MX
www.atuttadestra.net.	A
mx1.onlink.net.	A
www.kingdomplantae.net.	AAAA
wiki.vps.net.	A
downtownla.com.inbound10.mxlogic.net.	A
gadgets.boingboing.net.	AAAA
www.vencom.net.	A
www.mcse.net.	A
barberarchitecture.com.inbound35.mxlogic.net.	A
dls.smartmovies.net.	A
inbound.strathome.net.netsolmail.net.	A
fenris.net.	MX
veoh-229.vo.llnwd.net.	A
ameribiz.net.	A
mail3.contato.net.	AAAA
www.kizi4.net.	A
www.benbarnes.net.	A
www.pbrc.net.	A
samarco.net.	MX
armgroup.net.	MX
onyxws.com.inbound20.mxlogic.net.	A
forum.lighttpd.net.	A
isdn.net.	A
cdn.rugerforum.net.	A
westauckld.npclass.hop.clickbank.net.	A
doubleclick.net.	MX
opendll.net.	A
www.dermatologia.net.	A
inbound.harteng.com.netsolmail.net.	A
pwireless.net.	A
aguestbook.sourceforge.net.	A
rieker.net.	MX
oneway.net.	MX
mail.mail54.us1.rsgsv.net.	A
ekurd.net.	A
menshairstyles.net.	A
grlnet.net.	A
inlinechiro.net.	A
gfk_us-us.sensic.net.	AAAA
dapelectric.com.inbound10.mxlogicmx.net.	A
conpst.112.2o7.net.	A
wheatonsportcenter.com.inbound15.mxlogicmx.net.	A
bmgmt.net.	MX
hospicecare.net.	MX
www.vasosdeplastico.net.	A
onlineguru.112.2o7.net.	A
wac.0b02.edgecastcdn.net.	A
blog.tribalwarsmasters.net.	A
ecards.alege.net.	A
www.shemale-angels.net.	A
www.islammen.net.	AAAA
ecscontracting.net.	MX
www.child.net.	A
maxgaming.net.	A
www.alkitodo.net.	A
fm.net.	MX
shbllp.com.inbound15.mxlogic.net.	A
eventusmarketing.com.inbound10.mxlogicmx.net.	A
dominorealty.com.inbound20.advancedse.net.	A
feeds.japan.cnet.com.cdngc.net.	AAAA
inn.net.	MX
soundbridge.net.	MX
a672.w23.akamai.net.	A
e3003.b.akamaiedge.net.	AAAA
inbound.cragoe.net.netsolmail.net.	A
www.girlsgogames.it.cdngc.net.	A
www.zune.net.	A
www.ilovearsenal.net.	A
www.spirit-dalida.forumactif.net.	A
mectron.net.	MX
www.getrippedabs.net.	AAAA
www.alejabiya.net.	AAAA
www.saminablog.net.	A
www.juegosdegolf.net.	AAAA
www.stroitelstvo.net.	MX
simmons-corp.com.inbound10.mxlogic.net.	A
lek.net.	MX
www.tvgems.net.	AAAA
www.pause-jeux.net.	A
mail.s191-1.charter-business.net.	A
a1311.da1.akamai.net.	AAAA
burger.rioangrybirds.net.	A
mail.durosa.net.	A
drrrhyhe9lfip.cloudfront.net.	AAAA
a1857.da1.akamai.net.	A
www.avparadise.net.	AAAA
pasadenacenter.com.inbound15.mxlogic.net.	A
img75.pixiv.net.	AAAA
halloween.whipnet.net.	A
a439.da1.akamai.net.	AAAA
amazonm-519.vo.llnwd.net.	A
216-176-124-176.rtccom.net.	A
www.cdrberlin.net.	A
divem.net.	MX
tecnosistema.net.	A
para-colorir.net.	A
daffy.za.net.	A
msnportallatino.112.2o7.net.	AAAA
arn.net.mx4.amatechtel.rcimx.net.	A
fwmortgage.net.	MX
tle.net.	MX
www.aaronwest.net.	A
music.fetnet.net.	A
eckorea.ecplaza.net.	A
abilityone.com.inbound15.mxlogic.net.	A
ns3.ristech.net.	A
s4.ru.alaplaya.net.	A
ipo.net.	A
support.cpanel.net.	A
www.golgolgol.net.	A
wordrider.net.	MX
m5corp.net.	MX
www.computrabajo.net.	A
eipcp.net.	AAAA
download.sourceforge.net.	A
town-eastonmd.com.inbound15.mxlogicmx.net.	A
nsighttech.com.inbound20.mailprotector.net.	A
mauri.lacoctelera.net.	A
a1031.g.akamai.net.	AAAA
groupc.com.inbound15.mxlogic.net.	A
divisionbyzero.net.	A
mail.plaintalk.net.	A
kate.net.	MX
newchance.net.	MX
mail.subether.net.	A
ioc.net.	A
cp96798.live.edgefcs.net.	AAAA
inbound.willysgym.com.netsolmail.net.	A
zeldadungeon.net.	AAAA
pigeond.net.	AAAA
everlite.net.	A
a1808.phobos.apple.com.edgesuite.net.	A
cjbna.com.inbound35.mxlogicmx.net.	A
le.net.	A
e4999.b.akamaiedge.net.	AAAA
sa.betait.net.	A
www.skinnysupergirls.net.	AAAA
porta.net.	A
proidgy.net.	MX
dtccom.net.	A
www.movierulez.net.	A
www.pelitube.net.	AAAA
mail2.atlasbox.net.	A
anime-delta.forouruguay.net.	A
live3.monitus.net.	AAAA
tops.tsahim.net.	AAAA
kurt-angle.net.	AAAA
lib.sawadee.net.	A
www.america890.net.	A
gittenslaw.com.inbound10.mxlogic.net.	A
s1.ph.126.net.	A
amanpalestin.net.	A
tundratalk.net.	AAAA
www.cyclestreets.net.	A
naufrago.lacoctelera.net.	A
lego.112.2o7.net.	AAAA
ote.net.	MX
d1qzzfctbfyh6r.cloudfront.net.	A
iconnordic.112.2o7.net.	A
occitania.net.	MX
www.visitorsite.net.	A
kbbmain.112.2o7.net.	A
mail.botwin.net.	A
www.charlottecooper.net.	A
dtellxyczv9cm.cloudfront.net.	A
inbound.edwardsrefrigeration.com.netsolmail.net.	A
rc.bx9.net.	A
www.mordormx.net.	A
www.solotrucos.net.	A
mailgate1.netivo.net.	A
nix.globale.net.	AAAA
a1455.x.akamai.net.	A
p04-fmipmobile.icloud.com.akadns.net.	A
elcaballeroeburneo.foroes.net.	A
www.ljshopping.net.	A
www.stilar.net.	A
thomp.20q.net.	AAAA
horizonconcepts.net.	MX
terra.talksport.net.	A
c21rg.net.	A
subs.asia-team.net.	AAAA
karmicdebt.net.	A
notthoff.com.inbound10.mxlogic.net.	A
arkadinproduction.net.	A
cnqdmail.cnqd.net.	A
thei.net.	MX
xirrus.com.inbound15.mxlogic.net.	A
www.tvonlinepaulista.net.	AAAA
n6rpf.com-us.net.	A
deetag.com.inbound10.mxlogicmx.net.	A
inedicola.quotidiano.net.	A
passportunlimited.com.inbound15.mxlogicmx.net.	A
hopearkansas.net.	MX
asterix-y-obelix-juegos-olimpicos.programas-gratis.net.	A
rizon.net.	AAAA
www.tech-pro.net.	AAAA
whl.net.	MX
cqbleone.net.	A
a988.da1.akamai.net.	A
selsoft.net.	MX
img2.depravedmoms.net.	AAAA
www.jar-online.net.	A
ampad.net.	A
drvicon.sourceforge.net.	A
e1289.b.akamaiedge.net.	AAAA
unattended.sourceforge.net.	A
2b.img.v4.skyrock.net.	A
princess.creditu.net.	AAAA
sjearthquakes.com.inbound15.mxlogicmx.net.	A
a504.phobos.apple.com.edgesuite.net.	A
mail.mcd.net.	A
d3rufoqhb6ap02.cloudfront.net.	AAAA
rio-express.net.	MX
cp101675.edgefcs.net.	AAAA
www.ahsanululoom.net.	A
smcars.net.	AAAA
agconcepts.com.inbound15.mxlogic.net.	A
blog.sergioalvarez.net.	A
www.philipbloom.net.	AAAA
d3gkbha1s7sr56.cloudfront.net.	AAAA
www.hulantrading.net.	A
kekohotel.net.	AAAA
weddingbedbathbeyond.112.2o7.net.	A
protecgroup.com.inbound10.mxlogicmx.net.	A
my.xuite.net.	AAAA
e4254.b.akamaiedge.net.	AAAA
login.icq.net.	A
a.d1.yimg.com.edgesuite.net.	AAAA
www.visualillusion.net.	A
fuze.net.	MX
inbound.theofficecenter.net.netsolmail.net.	A
sunsetbaymarina.net.	A
noautorun.sourceforge.net.	A
dyktg2dmpe6pm.cloudfront.net.	A
alert.jobsonlinemail.net.	A
www.faico.net.	A
vmx.kxra.com.redcondor.net.	A
atis.net.	MX
www.libyanconstitutionalunion.net.	A
cdn.theguardian.com.c.footprint.net.	AAAA
a661.da1.akamai.net.	AAAA
thenebula.net.	A
www.exagono.net.	AAAA
wpcs.net.	MX
proxypartners.com.inbound10.mxlogic.net.	A
mail2.xe2hosting.net.	A
tpepinc.com.inbound20.mxlogic.net.	A
www.arbworld.net.	A
cgroupusa.com.inbound15.mxlogic.net.	A
www.hannah-hilton.net.	AAAA
host47.greenhand.net.	A
ctasap.esc4.net.	A
universalia.com.inbound10.mxlogic.net.	A
www.infodabidjan.net.	A
www.roughanalsex.net.	AAAA
www.webwallpaper.net.	A
www.shadowandy.net.	A
ptyd.net.	MX
cherokeetel.net.	MX
hi-games.net.	A
compu.net.	MX
netflix781.pop3.la.nflximg.com.edgesuite.net.	A
writingjob.rinc1.hop.clickbank.net.	AAAA
aggeophysical.com.inbound10.mxlogicmx.net.	A
tessera.com.inbound15.mxlogicmx.net.	A
mouse-mischief.programas-gratis.net.	A
dakota.gate.net.	MX
artplumbing.com.inbound15.mxlogic.net.	A
aicventures.com.inbound15.mxlogic.net.	A
mail-proxy2.nbis.net.	A
empleo.universiablogs.net.	AAAA
dadnbjzbbks0y.cloudfront.net.	AAAA
www.madein.net.	A
inbound.targe-energy.com.netsolmail.net.	A
www.bravedigger.net.	AAAA
remnant.fmpub.net.	A
www.quikr.com.edgesuite.net.	A
www.cordstrap.net.	A
tpappsextu01.tele.net.	A
www.dibujandoamerica.net.	A
a1817.g.akamai.net.	AAAA
tricongeophysics.com.inbound15.mxlogicmx.net.	A
www.justnodoubt.net.	A
nlrg.com.inbound10.mxlogic.net.	A
mail.whsecure.net.	A
horison.net.	A
m2studio.net.	A
inbound.fibersound.com.netsolmail.net.	A
kraftfoods.taleo.net.	AAAA
d315qb486u3g7l.cloudfront.net.	A
mailhost.vtrip.net.	A
bzpic.xici.net.	A
176d0gruo923oh0-wahn5v7w15.hop.clickbank.net.	A
texol.net.	A
forex.negocio-internacional.net.	A
zilvia.net.	AAAA
www.frases-bonitas.net.	A
top.cityua.net.	A
nebula.programas-gratis.net.	A
peopleplusinc.net.	A
pointeblank.net.	MX
www.jazzlinks.net.	A
remail.mfcu.net.	A
smtp.paradise.net.	A
www.petulaclark.net.	A
fhcs.org.inbound15.mxlogic.net.	A
d7qizb8q1uuby.cloudfront.net.	A
inbound.northernelectricco.com.netsolmail.net.	A
ban.yournailed.net.	A
filter.gdcllc.net.	A
spam.qualitech.net.	A
e4404.b.akamaiedge.net.	AAAA
flacpa.com.inbound40.mailprotector.net.	A
christiancamps.net.	MX
agriplus.net.	MX
vbnarch.com.inbound15.mxlogic.net.	A
p08-fmf.icloud.com.akadns.net.	AAAA
mail.tmd.net.	A
sunridgenurseries.com.inbound15.mxlogic.net.	A
www.nospank.net.	A
spamfilter.exclusief.net.	A
mail.graphicshouse.net.	A
mfld.net.	A
auto.rlslog.net.	A
megaevents.net.	AAAA
wvaz-fm.akacast.akamaistream.net.	A
www.marcelomagalhaes.net.	AAAA
vallejo.ural.net.	A
anekdot.fishki.net.	AAAA
ubuntu-xp.programas-gratis.net.	A
a115.c.akamai.net.	A
www.lafermeduweb.net.	AAAA
lists.commerce.net.	A
a1271.di3.akamai.net.	A
a1923.phobos.apple.com.edgesuite.net.	AAAA
test.wpat.net.	A
sakao.net.	MX
brandes-assoc.com.inbound10.mxlogic.net.	A
c151.net.	A
pub.wx.jsinfo.net.	MX
www.integrationsolutions.net.	A
batchoy.net.	A
amazonm-107.vo.llnwd.net.	A
cinestrenostv.net.	AAAA
wiki.fdiary.net.	A
how-to-get-rid-of-bedbugs.net.	AAAA
poi.net.	MX
dns4.sef.pnap.net.	MX
www.omusicawards.com.edgesuite.net.	AAAA
mx.eemms.net.	A
a1307.b.akamai.net.	A
ip-184-168-82-197.ip.secureserver.net.	A
mail.kg21.net.	A
firstchoicesolutions.net.	MX
www.palacity.net.	A
dsn5.skype-dsn.akadns.net.	A
mfddlaw.com.inbound45.mxlogic.net.	A
nep.net.	A
teleshare.net.	A
www.guate.net.	A
konjugator.reverso.net.	A
relay1.netnames.net.	AAAA
fmpueblo.radioteca.net.	A
winelev11wii.ms13.gs.nintendowifi.net.	A
geba.net.	A
klimovsk.net.	MX
feltontel.net.	MX
www.carantha.net.	A
manciniduffy.com.inbound20.mxlogic.net.	A
islamophobie.net.	MX
blogtiengviet.net.	A
pupdate-aa.avg.com.edgesuite.net.globalredir.akadns.net.	A
seteusa.com.inbound15.mxlogic.net.	A
www.sexshop.net.	AAAA
1dfc504ojyhq6-9p37te-jklzu.hop.clickbank.net.	A
mxfilter2.sui-inter.net.	AAAA
inkanime.net.	AAAA
www.free-tarot-reading.net.	A
www.robotto.net.	A
mta-inbound.cluster3.convio.net.	A
emurayden.net.	A
thecolonialpress.net.	MX
joneol.tk1000.net.	A
iolfree.net.	A
mail.vns.net.	A
dataframe.net.	MX
www.crearmundos.net.	A
smtp.hyperride.net.	A
inkart.net.	A
ejvs.dnsalias.net.	MX
inbound.browncountylogcabins.com.netsolmail.net.	A
www.stockinglive.net.	AAAA
netflix562.pop2.la.nflximg.com.edgesuite.net.	A
evepdeagledev.112.2o7.net.	AAAA
ww2.supergt.net.	A
darulkautsar.net.	A
aristechacrylics.com.inbound15.mxlogic.net.	A
globalbiz.net.	A
e4156.g.akamaiedge.net.	A
mx0.wyverex-cave.net.	A
a990.da1.akamai.net.	AAAA
www.webcamsxxx.net.	A
inbound.rwlarsonarchitects.com.netsolmail.net.	A
fec07280.realfiles.net.	A
titanconsulting.net.	MX
fusionuv.com.inbound15.mxlogic.net.	A
a151.d.akamai.net.	MX
inbound.thatcheroaks.com.netsolmail.net.	A
msc.scouts-es.net.	AAAA
inbound.circleporsche.com.netsolmail.net.	A
www.theraffon.net.	AAAA
a116.g.akamai.net.	AAAA
datacolor.com.inbound10.mxlogic.net.	AAAA
btanks.sourceforge.net.	A
www.digitalcraftsmen.net.	AAAA
nanologistics.net.	MX
sns7.rsys1.net.	A
mail.efdgroup.net.	A
netbiz.net.	A
mail.stringa.net.	A
ecommerce.sittnet.net.	A
wilen.com.inbound15.mxlogic.net.	A
bigred.com.inbound15.mxlogic.net.	A
pop3.smartstream.net.	A
rwli.net.inbound15.mxlogicmx.net.	A
thejobplace.net.	MX
mail.jp.viruscheck.net.	A
www17.moba8.net.	A
static.move.com.cdngc.net.	AAAA
stablet-e.np.dl.playstation.net.	A
worldsites.net.	MX
worldhealth.net.	A
41.media.v4.skyrock.net.	A
www.dtforum.net.	AAAA
dx3.divxhosting.net.	A
lx.net.	A
mrhiggins.net.	A
mail.cbflorida.net.	A
mctdairies.com.inbound15.mxlogic.net.	A
guebertlaw.com.inbound25.mailprotector.net.	A
a1681.phobos.apple.com.edgesuite.net.	A
www.vooks.net.	A
network.lovearth.net.	A
aaicinc.com.inbound15.mxlogic.net.	A
cdn-forums.precentral.net.	AAAA
www.joluba.net.	A
mail7.hostinguk.net.	A
carolinaapothecary.com.inbound15.mxlogic.net.	A
caretechgroup.com.inbound15.mxlogicmx.net.	A
msifla.net.inbound15.mxlogicmx.net.	A
betaengineering.com.inbound10.mxlogicmx.net.	A
dartmail.net.	A
cnc.net.	MX
stealth.lweb.net.	A
barracuda.mvla.net.	A
www.verygames.net.	A
cdl.net.	A
hitler.net.	A
www.stolenvideos.net.	A
radioartnet.net.	A
mtbest.net.	A
www.angelspit.net.	A
www.playingbythebook.net.	A
biawest.net.	MX
www.misionweb.net.	A
sparboe.com.inbound10.mxlogic.net.	A
a1465.da1.akamai.net.	AAAA
saintjohns.net.	MX
www.boy-drive.net.	A
ns2.md-13.webhostbox.net.	A
links.net.	AAAA
ua.net.	MX
dynamic-copywriting.net.	MX
108-82-124-137.lightspeed.irvnca.sbcglobal.net.	A
mailbk.brandwatch.net.	A
mail.jianlibao.net.	A
www.cineco.net.	A
bicycledesign.net.	A
pagenetmessage.net.	A
www.daedally.net.	A
www.motorcycletrader.net.	A
nodvd.net.	AAAA
airdefense.net.	MX
tri-countyinsurance.net.	MX
alcf.net.	MX
mail.accessky.net.	A
www.sims3updates.net.	A
netflix178.pop2.la.nflximg.com.edgesuite.net.	A
port73.mx14.sps.mxfw.net.	A
www.eeoc.net.	A
cadenacope.net.	MX
notd.net.	MX
softeng.blob.core.windows.net.	A
audiag.112.2o7.net.	A
podnapisi.net.	A
www.easst.net.	A
yanoff.com.inbound10.mxlogic.net.	A
brightcove-49.fcod.llnwd.net.	A
wbokwireless.net.	MX
poe.net.	MX
mahjong-suite.programas-gratis.net.	A
leasecorp.com.inbound10.mxlogic.net.	A
a503.da1.akamai.net.	AAAA
ectts.com.inbound15.mxlogicmx.net.	A
axiom.net.	MX
corp03.web.pitdc1.expedient.net.	A
wpc.3920.edgecastcdn.net.	A
webcam-video-capture.programas-gratis.net.	A
consultancy.edvoncken.net.	AAAA
mobile-tracker.gameduell.net.	A
hdflashkjerag-f.akamaihd.net.	A
dismashousekc.com.inbound10.mxlogic.net.	A
evolutionibus.eresmas.net.	A
caller.collegefootball.upickem.net.	A
moynihanlumber.inbound20.mxlogicmx.net.	A
www.martinauer.net.	A
charterpa.net.	A
64.img.v4.skyrock.net.	AAAA
killing.rioangrybirds.net.	A
totsy.manumatix.net.	AAAA
vancouver.net.	MX
www.popon.net.	A
worldwidetravelclub.net.	MX
pfn.sourceforge.net.	AAAA
l2speed.net.mx1.l2speed-net.rcimx.net.	A
ns1.icg.net.	A
www.vitutor.net.	AAAA
t0.tiles.virtualearth.net.	AAAA
hospiceofmarion.com.inbound20.mailprotector.net.	A
ns1-2.akam.net.	AAAA
awebnet.net.	MX
appleauto1.com.inbound10.mxlogicmx.net.	A
www.labspaces.net.	AAAA
ufpi.com.inbound10.mxlogicmx.net.	A
birthdayexpress.com.edgesuite.net.	A
ns3.cloudns.net.	A
a555.g.akamai.net.	A
tw.battle.net.	A
mail.busink.net.	A
inbound.sarvega.com.netsolmail.net.	A
beauty.bgfashion.net.	AAAA
totalwrestling.foroactivo.net.	A
makeawish.112.2o7.net.	A
www.cathcom.net.	AAAA
t.williamgates.net.	A
barracuda.aiu3.net.	A
thefree.net.	A
kvmo.net.	A
mysteryscience.superforo.net.	A
mail.inwa.net.	A
wtc.mail.net.	A
unitedhomecare.com.inbound10.mxlogic.net.	A
vmai.net.	A
es.surveymonkey.net.	A
mail.i-america.net.	MX
datastream.net.	A
www.sizeguide.net.	AAAA
hotmail.com-login.fyxm.net.	A
schuylkillvalley.org.inbound10.mxlogicmx.net.	A
ingram.122.2o7.net.	AAAA
bethellaw.net.	A
mexico.elmenudeldia.net.	A
cfisd.net.	A
inbound.tileanddesigns.com.netsolmail.net.	A
www.lantalk.net.	A
www.vivawoman.net.	A
inbound.dksuites.com.netsolmail.net.	A
buttobi.net.	MX
www.beeeeee.net.	A
the-fastest.net.	MX
www.becamec.net.	A
optica.machorro.net.	A
parrlaw.com.inbound10.mxlogic.net.	A
www.coolios.net.	A
www.zientzia.net.	AAAA
www8-ssl.effectivemeasure.net.	AAAA
unifiedculture.net.	MX
verzion.net.	A
animenexus.net.	A
mx.japinuco.net.	A
omahaweb.net.	MX
ibbd.net.	MX
img4.minifav.net.	AAAA
manchey.softarchive.net.	A
pxndx.net.	A
nashville.net.	MX
music.friv10.net.	AAAA
deskscapes.programas-gratis.net.	A
e100a7heg3z7b6n5m8mkgcw2uk.hop.clickbank.net.	AAAA
a1998.da1.akamai.net.	AAAA
ecagt.com.inbound10.mxlogic.net.	A
emediate.apmmedia.net.	MX
safetyplus.net.	A
rwhomes.net.	A
cdn.krxd.net.	AAAA
ffog.net.	A
puresugar.net.	A
huntleyfamily.net.	MX
2khiway.net.	MX
nwmanagement.net.	MX
westvirginia.net.	MX
mailviruswall1.internet-fr.net.	A
www.nickjr.com.edgesuite.net.	A
netflix952.pop2.la.nflximg.com.edgesuite.net.	A
fulvetta.riseup.net.	A
mailin-02.incoming.addaction.net.	A
crl.www.ms.akadns.net.	MX
imprintswholesale.com.inbound20.mxlogic.net.	A
www.logeek.net.	A
jennifer-love-hewitt.programas-gratis.net.	A
benefitconceptsinc.com.hostedsecurity.paetec.net.	A
www.venezia.net.	A
mateo.net.	A
gmlave.112.2o7.net.	AAAA
chardonlabs.com.inbound10.mxlogic.net.	A
capellinewyork.com.inbound10.mxlogicmx.net.	A
duocpogpi5hgf.cloudfront.net.	A
thechap.net.	MX
ns1.tracom.net.	A
ci.american-canyon.inbound10.mxlogic.net.	A
rewcorp.com.inbound15.mxlogicmx.net.	A
mail01.dd24.net.	A
www.top13.net.	A
inbound.dlnk.com.netsolmail.net.	A
admin.ru.net.	MX
inbound.fourseas.net.netsolmail.net.	A
capellinisalon.net.	MX
neumanus.com.inbound30.mxlogicmx.net.	A
mail.graphictraffic.net.	A
cdcd9mi7n6icebsd4dm4upcm4r.hop.clickbank.net.	A
www.uragentzia.euskadi.net.	AAAA
relay.asacco.net.	A
themetropolitanbank.com.inbound30.mailprotector.net.	A
intervida.net.	MX
ismtp.wyoming.everyone.net.	A
aacplus-ac-32.as34763.net.	A
www.hwslash.net.	A
grandecon.net.	A
inbound.goera.com.netsolmail.net.	A
www.remote-dba.net.	A
veoh-179.vo.llnwd.net.	A
a1441.w11.akamai.net.	A
ns2.voxcdn.net.	A
futurepharmacist.net.	MX
log.releware.net.	AAAA
as.adfonic.net.	AAAA
interpals.net.	AAAA
orionce.net.	AAAA
nav.tns-cs.net.	A
karhoff.net.	A
remote.coxmotors.net.	A
albacete.evisos.net.	A
inbound.erbs.net.netsolmail.net.	A
www.viewpointonline.net.	A
mail2.yourserver.net.	A
wmlaw.net.	MX
www.elholocausto.net.	A
www.usnews.com.edgesuite.net.	A
account.live.com.nsatc.net.	MX
nc-public.sc.cninfo.net.	A
www.urinal.net.	AAAA
www.cdtinternet.net.	A
gold.linx.net.	A
dns4.uslec.net.	AAAA
ns1-e.dns.pipex.net.	AAAA
a4.da1.akamai.net.	AAAA
upload.nicematin.net.	AAAA
pdmm.us.inbound10.mxlogic.net.	A
gaspars.com.inbound10.mxlogic.net.	A
cdn.gtcdn.net.	AAAA
www.strangescience.net.	A
transformit.com.inbound10.mxlogic.net.	A
landthumb.phinf.naver.net.	A
www.interfacejournal.net.	A
metalscript.net.	A
ns2.astelhost.net.	A
seiccs.com.inbound15.mxlogic.net.	A
tr7live.superforo.net.	A
shpi.net.	MX
ns1.performancehosting.net.	A
www.gaywinners.net.	A
www.zeldaforums.net.	A
e1267.d.akamaiedge.net.	A
mx0.wbhst.net.	MX
www.sheylahershey.net.	AAAA
www.ly2l.net.	AAAA
carlos-s.lacoctelera.net.	A
inbound.albiladhotel.com.netsolmail.net.	A
bellsoutn.net.	A
www.cuandocalientaelsol.net.	AAAA
alcardio.com.inbound10.mxlogic.net.	A
shira.net.	MX
www.fleetairarmarchive.net.	A
www.newgames.net.	A
dawn.forums1.net.	A
focusenv.com.inbound15.mxlogic.net.	A
mail.took.net.	A
bwyze.com.inbound10.mxlogic.net.	A
wbnispblogsext.112.2o7.net.	A
pdf1.alldatasheet.net.	A
newmiamirealty.com.inbound10.mxlogic.net.	A
amazonm-723.vo.llnwd.net.	A
www.tech-forums.net.	A
tratamientosfaciales.net.	A
poesiasdelcorazon.p.o.pic.centerblog.net.	A
smtp.fiberpipe.net.	A
cfile13.uf.daum.net.	AAAA
img.uptodown.net.	A
skype.tt.omtrdc.net.	A
topman.com.112.2o7.net.	A
js.live.net.	A
virtualdesign.net.	A
www.intel-sino.com.edgesuite.net.chinaredirector.akadns.net.	AAAA
www.calangodocerrado.net.	A
perrosycachorros.net.	A
usain.com.inbound10.mxlogicmx.net.	A
reporte.tvazteca.net.	A
angryfrogs.net.	A
wac.543b.edgecastcdn.net.	A
davidkensington.com.inbound10.mxlogic.net.	A
celotextrust.com.inbound10.mxlogicmx.net.	A
tcgroup.net.	MX
www.fox8live.com.cdngc.net.	A
siliconpower.com.inbound15.mxlogic.net.	A
antimoneylaundering.net.	A
systex.net.	MX
www.dailysolutions.net.	A
mail.cypresshealthcare.net.	A
valiant-ny.com.inbound10.mxlogicmx.net.	A
astleford.com.mx1.visi.rcimx.net.	A
a1384.da1.akamai.net.	A
www.smawi.net.	A
sifontes.net.	MX
madmaxnl.tweakblogs.net.	A
munge-explorer-tool.programas-gratis.net.	A
bensbargains.net.	A
static.computing.net.	AAAA
johnmacfarlane.net.	AAAA
mail.minuit.net.	A
laguna.balt.net.	A
jeffareid.net.	A
dl0p2rrksnwxa.cloudfront.net.	A
inf.korrespondent.net.	A
safetgard.com.inbound15.mxlogicmx.net.	A
mx2.go2infinity.net.	A
inbound.niswander.com.netsolmail.net.	A
b2.us.np.communication.playstation.net.	A
dev.pixiv.net.	AAAA
2fbe199b.realfiles.net.	A
inbound.venablesconstruction.com.netsolmail.net.	A
verigent.com.inbound10.mailprotector.net.	A
www.audiojuegos.net.	A
mx.online.net.	AAAA
optimaxbd.net.	MX
kattisdolls.net.	A
style-xp-para-hombres.programas-gratis.net.	AAAA
images-design.foroactivo.net.	A
destinyusa.com.inbound10.mxlogic.net.	A
upc.d2.sc.omtrdc.net.	AAAA
mx.bewoopi.net.	MX
porterindustries.com.inbound15.mxlogicmx.net.	A
notifight.net.	A
mail.gdisigns.net.	AAAA
kids.daum.net.	A
gorlovka.net.	MX
pyzor.sourceforge.net.	A
www.morevision.net.	A
cp147337.edgefcs.net.	A
www.mallenbaker.net.	A
inbound.ronlbishop.com.netsolmail.net.	A
d1au2fplbcmd98.cloudfront.net.	AAAA
cp60694.live.edgefcs.net.	A
eprodigy.net.	MX
murrieta.net.	MX
innernet.net.	A
azicom.net.	MX
brianbear.net.	A
winnie.sbor.net.	MX
pillargrp.com.inbound10.mxlogicmx.net.	A
noink.com.inbound15.mxlogic.net.	A
t9nav.net.	A
ber-mac.com.inbound35.mxlogic.net.	A
www.dreamwallpaper.net.	A
www.youngirlz.net.	A
seawaymfg.com.inbound25.mxlogic.net.	A
lockermp3.net.	AAAA
fabiandinkins.com.inbound15.mxlogicmx.net.	A
a4.sphotos.ak.fbcdn.net.edgesuite.net.	AAAA
randallmetals.com.inbound15.mxlogicmx.net.	A
p07-mobilebackup.icloud.com.akadns.net.	A
www-beta.statcounter.com.cdngc.net.	A
luma.sourceforge.net.	AAAA
ns0-d.dns.pipex.net.	AAAA
decolux.net.	MX
a990.x.akamai.net.	A
rehab.gupco.net.	A
chartercom.net.	A
www.trukitos.net.	AAAA
schatzins.com.inbound10.mxlogicmx.net.	A
www.medicalebooks.net.	AAAA
inbound.terrytownrv.com.netsolmail.net.	A
www.oman0.net.	A
clm.co.uk.inbound10.emea.mxlogicmx.net.	A
mail.mushtaha.net.	A
jupiter.espoltel.net.	MX
www.neuronasoft.net.	A
inbound.dkarndtcpa.net.netsolmail.net.	A
sbdns3.cscdns.net.	A
a462.g.akamai.net.	A
csc.beap.ad.yieldmanager.net.	MX
amazonm-629.vo.llnwd.net.	A
precisionrealestate.net.	MX
a-patch-windows-live-messenger-8-0.programas-gratis.net.	AAAA
inbound.dwyoung.com.netsolmail.net.	A
mailfilter.compuplus.net.	A
nicole20.centerblog.net.	A
wallbase.net.	AAAA
www.screensavour.net.	AAAA
cp99077.live.edgefcs.net.	AAAA
gazerock-mexico.foroactivo.net.	A
plandatamgmt.com.inbound15.mxlogic.net.	A
tpappsextu01.tele.net.	AAAA
mail.nightstar.net.	A
www.waliberals.net.	A
csbcpa.com.inbound15.mxlogic.net.	A
www.alfilodelocutre.net.	A
inv75-2-82-229-190-6.fbx.proxad.net.	MX
katokenzai.net.	MX
www.dj.net.	A
samec.net.	A
www.palabrita.net.	A
chartwe.net.	A
mx5.webville.net.	A
auth04.ns.de.uu.net.	AAAA
gwinnroby.com.inbound15.mxlogic.net.	A
inference.location.live.net.	A
www.friendsalarm.net.	AAAA
www.results-page.net.	A
www.dvidshub.net.	AAAA
d1bchs39hew8h1.cloudfront.net.	A
bristolmanagement.com.inbound15.mxlogicmx.net.	A
wpc.2be5.edgecastcdn.net.	A
www.falconops.net.	A
britney-spears.net.	A
theoaksonline.org.inbound15.mxlogicmx.net.	A
fidanquetravel.com.inbound15.mxlogic.net.	A
catalogliving.net.	A
primeis.com.inbound15.mxlogic.net.	A
danceexpression.net.	A
forum.adunanza.net.	AAAA
59.art.skyrock.net.	A
mx.shaik.net.	A
www.hotgirlsvideos.net.	AAAA
videos.videomasti.net.	AAAA
a1669.b.akamai.net.	A
a766.w33.akamai.net.	A
john.albin.net.	A
mail2.bickford.net.	A
mail.tusnya.net.	A
fertilab.net.	A
mailcleaner.regiogate.net.	A
nestscape.net.	MX
treecarescience.com.inbound15.mxlogic.net.	A
mail.tveita.net.	A
images.traveltoday.net.	AAAA
ektron.com.inbound10.mxlogicmx.net.	A
www.ypms.net.	A
idirectory.xgns.net.	AAAA
alintaassist.net.au.inbound15.mxlogic.net.	A
dxuu1kmv6dm3n.cloudfront.net.	A
cfile117.uf.daum.net.	A
tool.donation-net.net.	A
ns1-160.akam.net.	AAAA
www.evony.net.	A
isketch.net.	AAAA
www.spyhiddencam.net.	AAAA
it-broker.net.	MX
26.mgl.skyrock.net.	A
fanfares.com.inbound10.mxlogic.net.	A
arbinc.net.	MX
www.tube777.net.	A
www.golondrina.net.	AAAA
anyksciuvb.cjb.net.	A
mobiusriskgroup.com.inbound10.mxlogicmx.net.	A
off.net.	A
dnvrlaw.com.inbound10.mxlogicmx.net.	A
oranger.net.	A
www.x05.net.	A
gw.dd-b.net.	A
robertstock.net.	MX
hollman.com.inbound10.mxlogic.net.	A
www.ekouhou.net.	A
b1.phixr.net.	AAAA
pdn.net.	A
taylorpictures.net.	AAAA
toics.2cnt.net.	A
bowtie-bio.sourceforge.net.	AAAA
myall.net.	A
www.lakeone.net.	A
xplane.programas-gratis.net.	AAAA
mx02.iacd.net.	AAAA
ntp.sipgate.net.	A
15.img.v4.skyrock.net.	A
msg.louhi.net.	A
ratestar.net.	A
telus-notification.radialpoint.net.	AAAA
ruskinconstruction.com.inbound10.mxlogic.net.	A
orient-usa.com.inbound15.mxlogicmx.net.	A
flinttrust.com.inbound15.mxlogicmx.net.	A
ns0.ida-office.net.	MX
letras-y-numeros.dibujos.net.	AAAA
attcanada.net.	MX
sri-lankan.net.	A
shoot-em-up.friv-games.net.	A
a1537.da1.akamai.net.	AAAA
www.clicjeux.net.	A
d2z57atfnbxql8.cloudfront.net.	A
extensions.isg-apple.com.akadns.net.	A
cot.net.	MX
crazy-racing-cars.programas-gratis.net.	A
inbound.dancopump.com.netsolmail.net.	A
mail60.us1.rsgsv.net.	MX
amhcapital.net.	MX
lefima.net.	A
www.blog-transsexuel.net.	AAAA
www.ayecarumba.net.	A
www.cnee-sur.net.	A
mail.calvarynet.net.	A
amazonm-982.vo.llnwd.net.	A
portcontractors.com.inbound15.mxlogic.net.	A
mail.talon.net.	A
smtp.heritagepaper.net.	A
