help.optuszoo.com.au.	A
birst.com.au.	A
keytek.com.au.	A
www.samesame.com.au.	A
www4.gu.edu.au.	AAAA
www.inkdepot.com.au.	A
universalbar.com.au.	A
www.usp.com.au.	A
iinet.com.au.	A
laurenceassociates.com.au.	MX
fallbackfilter2.spamhijacker.com.au.	A
www.intunity.com.au.	AAAA
www.conrad.com.au.	A
nbcf.org.au.	A
connect.com.au.	MX
smtp.netcore.com.au.	A
securitynetwork.com.au.	A
ias.qut.edu.au.	A
www.cad.com.au.	A
www.channeladvisor.com.au.	AAAA
directory.weddingcentral.com.au.	A
www.curtin.edu.au.	AAAA
www.dynamicgift.com.au.	A
mail.god.net.au.	A
www.evolutionmediagroup.com.au.	A
nicholeslaw.com.au.	MX
www.lennoxaus.com.au.	A
www.mydailynews.com.au.	A
edumail.vic.gov.au.	MX
ento.csiro.au.	MX
www.dolly.com.au.	AAAA
tnt.com.au.	AAAA
www.arbgames.com.au.	AAAA
buyingcars.com.au.	A
epson.com.au.	MX
mxp.com.au.	A
quattrohair.com.au.	A
www.zoology.unimelb.edu.au.	AAAA
parks.vic.gov.au.	A
ausport.gov.au.	A
www.educ.utas.edu.au.	A
lifeline.org.au.	MX
www.mypolishedconcrete.com.au.	A
efront.com.au.	A
mail.lmr-roofing.com.au.	A
forums.greekcity.com.au.	A
www.jehbcosilicones.com.au.	AAAA
philipwebb.com.au.	MX
australianballet.com.au.	MX
www.uniquecarsandparts.com.au.	A
www.sanuk.com.au.	AAAA
stats.sydney.edu.au.	AAAA
talent2.com.au.	A
insvr1.midcoastwater.com.au.	AAAA
www.tai.org.au.	AAAA
mx1.hsvision.firstwave.com.au.	A
pc.gov.au.	AAAA
kolbe.wa.edu.au.	MX
humedoorsqld.com.au.	A
greensteel.com.au.	MX
secondary.ampwest.com.au.	A
mail.spbgroup.com.au.	A
bootlegs.elvis.com.au.	A
www.mamere.com.au.	A
www.shapestation.com.au.	A
www.racecoursemotors.com.au.	AAAA
www.helpmannawards.com.au.	AAAA
www.army.gov.au.	A
www.timmadden.com.au.	A
wintringham.org.au.	MX
www.tps.com.au.	AAAA
stramit.com.au.	AAAA
holroyd.nsw.gov.au.	A
mggs.vic.edu.au.	MX
shadesail.com.au.	MX
server1.grv.com.au.	A
interactive.qag.qld.gov.au.	A
keenproperty.com.au.	MX
www4.gu.edu.au.	A
www.kidscount.com.au.	AAAA
rtbu-nsw.asn.au.	AAAA
www.messengernews.com.au.	AAAA
www.thermaltake.com.au.	AAAA
percival.net.au.	MX
mail.yarratrams.com.au.	A
www.library.adelaide.edu.au.	AAAA
www.cleancruising.com.au.	A
mccartneyrealestate.com.au.	MX
www.aie.edu.au.	AAAA
www.kidspartycakes.com.au.	AAAA
ausfilm.com.au.	AAAA
oceanbooks.com.au.	MX
mail.sph.org.au.	A
www.australiangalleries.com.au.	A
panbio.com.au.	MX
randmbuilders.com.au.	MX
www.kangaroo-industry.asn.au.	A
capital-finance.com.au.	MX
mannatech.com.au.	MX
netxp.com.au.	MX
www.sce.edu.au.	A
www.catprotection.com.au.	AAAA
www.websitedesigncity.com.au.	A
resortbrokers.com.au.	A
www.iconinc.com.au.	A
www.megasmusic.com.au.	A
mail.infront.com.au.	A
www.studyinaustralia.gov.au.	A
www.poker.com.au.	A
www.theshedskatepark.com.au.	A
casr.adelaide.edu.au.	AAAA
www.liquidleds.com.au.	A
www.enterprisedata.com.au.	AAAA
www.magswitch.com.au.	AAAA
secure.healthlinks.net.au.	A
ns01.citec.com.au.	A
arlcollect.com.au.	AAAA
tcci.com.au.	MX
smtp2.optus.com.au.	A
www.jogging.com.au.	A
hickory.com.au.	AAAA
www.apn.com.au.	A
y5k.com.au.	MX
www.acl.org.au.	AAAA
mail.bedfordgroup.com.au.	A
fmtool.com.au.	A
www.coppel.com.au.	A
rscreative.com.au.	A
houseandgarden.com.au.	AAAA
henrietta.slwa.wa.gov.au.	A
www.redhillconsulting.com.au.	AAAA
mcgrathgroup.com.au.	A
services.nsw.gov.au.	A
clearspan.com.au.	MX
logitech.com.au.	MX
professionalconveyancing.com.au.	A
www.draftingconcepts.com.au.	AAAA
retailedge.com.au.	A
bonnieandneil.com.au.	A
www.naturalcity.com.au.	A
mx2.hambs.firstwave.com.au.	A
www.goldenplains.com.au.	A
ozguide.net.au.	A
mail.sandhurst.net.au.	A
bendigo.vic.gov.au.	A
www.fusiongear.com.au.	A
catalanoseafoods.com.au.	A
glrl.org.au.	A
www.digitalcameras.com.au.	A
backup-mx2.brennanit.net.au.	A
ibrs.com.au.	A
cbh.com.au.	AAAA
www.p2group.com.au.	A
mail.mentalhealth.asn.au.	A
auspine.com.au.	MX
www.gemtreevineyards.com.au.	A
www.amra.asn.au.	AAAA
oakhill.nsw.edu.au.	A
research.vu.edu.au.	A
clutchindustries.com.au.	AAAA
networkfirst.com.au.	MX
www.filmink.com.au.	AAAA
qldevents.com.au.	MX
dahlsens.com.au.	MX
www.meguiars.com.au.	AAAA
ipa.com.au.	A
grovecoms.net.au.	A
www.uo.com.au.	AAAA
cust-dns1.netspace.net.au.	A
www.hillssvl.com.au.	AAAA
ns1.comindico.com.au.	A
charlton.nsw.edu.au.	MX
nms.otc.telstra.com.au.	MX
emeraldpartners.com.au.	MX
www.interlloy.com.au.	A
lukebrown.com.au.	AAAA
mail.mlc.wa.edu.au.	A
cmielectrical.com.au.	MX
www.dingdonglounge.com.au.	A
www.carinsurancecover.com.au.	AAAA
iqcapital.com.au.	MX
www.tradingroom.com.au.	AAAA
pinpoint.benefits.com.au.	A
www.prospectroad.com.au.	A
www.repairnpaint.com.au.	A
hif.com.au.	AAAA
rav.vic.gov.au.	MX
www.actforpeace.org.au.	A
mail02.bottledomains.net.au.	A
www.accompli.com.au.	AAAA
oskar.com.au.	A
tencorporate.com.au.	AAAA
filter.austweb.com.au.	A
mail8.datacom.com.au.	A
cwgdogp.com.au.	MX
rugbywa.com.au.	MX
challenger.com.au.	AAAA
www.sydneyskydivers.com.au.	AAAA
mak.net.au.	MX
www.skynewsbusiness.com.au.	A
muirs.com.au.	AAAA
ugames.com.au.	MX
www.cavalierart.com.au.	AAAA
volunteergateway.monash.edu.au.	A
www.xylo.com.au.	AAAA
suzuki.com.au.	MX
cscc.com.au.	MX
www.countrypleasures.com.au.	A
csiro.au.	A
books.simonandschuster.com.au.	A
www.picnick.com.au.	A
qao.qld.gov.au.	MX
mdasa.org.au.	MX
www.insideout.com.au.	AAAA
www.rock.com.au.	A
rtpeople.com.au.	A
www.indianlink.com.au.	A
www.sat.justice.wa.gov.au.	A
strikebowlingbar.com.au.	AAAA
ns2.brennanit.net.au.	A
hades.bluefish.net.au.	A
amcoz.com.au.	MX
www.essentialaudio.com.au.	AAAA
www.crc-acs.com.au.	A
pubsites.uws.edu.au.	AAAA
www.catchmentdetox.net.au.	A
www.sgs.com.au.	A
mail.gleneira.vic.gov.au.	A
www.cnc-drives-controls.com.au.	A
hotkey.net.au.	MX
bisley.com.au.	MX
www.gaminglife.com.au.	AAAA
nhaustralia.com.au.	MX
myhub2.newcastle.edu.au.	AAAA
www.vulgar.com.au.	AAAA
graincorp.com.au.	MX
www.imvs.sa.gov.au.	A
www.printapromo.com.au.	AAAA
bigbangworldwide.blogspot.com.au.	A
altis.com.au.	A
search.stores.ebay.com.au.	AAAA
www.storytellersguide.com.au.	A
queens.unimelb.edu.au.	MX
www.acpmh.unimelb.edu.au.	AAAA
ibc.com.au.	MX
lhc.qld.edu.au.	MX
bridgeblue.com.au.	A
www.naismith.com.au.	AAAA
www.esquire.net.au.	AAAA
www.134tow.com.au.	A
dns-bris.cat.net.au.	A
mx9.det.wa.edu.au.	A
www.snugaustralia.com.au.	A
aussiemail.com.au.	AAAA
tig.net.au.	MX
andc.anu.edu.au.	A
mail.aquabait.com.au.	A
www.livescores.com.au.	A
www.countdown.com.au.	A
dreamcentre.com.au.	MX
stats.etrade.com.au.	AAAA
www.solarinverters.com.au.	AAAA
lucrf.com.au.	MX
www.stcatherines.net.au.	AAAA
wires.org.au.	A
www.adaustralia.com.au.	A
www.skillsone.com.au.	AAAA
www.nurturehouse.com.au.	A
www.six6photography.com.au.	A
collectionhouse.com.au.	MX
quotes.srw.id.au.	AAAA
www.popcornphotography.com.au.	A
www.storedj.com.au.	AAAA
meriton.com.au.	A
harrisgroup.net.au.	A
ifm.net.au.	A
mail.lyonsarch.com.au.	A
rmd.com.au.	A
www.city.mq.edu.au.	AAAA
enc.slq.qld.gov.au.	A
centenary.usyd.edu.au.	MX
www.minesite.com.au.	A
mail.cgd.vic.gov.au.	A
www.picturesofyou.com.au.	A
www.jinkyart.com.au.	AAAA
www.scotsice.com.au.	AAAA
www.andmercury.com.au.	A
cleantec.com.au.	MX
k6.boardofstudies.nsw.edu.au.	AAAA
www.chem.unsw.edu.au.	AAAA
www.metrosexualmale.com.au.	A
easterncreektavern.com.au.	A
bondi.austlii.edu.au.	A
blogs.adelaide.edu.au.	A
www.wazzawazzawazza.com.au.	AAAA
yourroom.com.au.	AAAA
coastchiro.com.au.	AAAA
detmold.com.au.	MX
www.shopbot.com.au.	A
filter2.cobsbr-1.mailguard.com.au.	A
images.atari.com.au.	AAAA
www.goondiwindiargus.com.au.	A
www.gravitybike.com.au.	A
fees.curtin.edu.au.	A
www.agnova.com.au.	AAAA
www.wickedtint.com.au.	A
www.justlocal.com.au.	A
kelcar.com.au.	MX
www.currency-converter.com.au.	AAAA
mailfilter.lwb.org.au.	A
handbook.curtin.edu.au.	A
www.omegaceramics.com.au.	A
www.csse.monash.edu.au.	A
melectrical.com.au.	MX
spf1.fitnet.com.au.	A
horansteel.com.au.	A
www.ixlappliances.com.au.	A
terrace.qld.edu.au.	MX
richardwaters.com.au.	MX
resourcerentals.com.au.	MX
www.quicken.com.au.	AAAA
www.its.uow.edu.au.	AAAA
email.cbre.com.au.	MX
wackado.com.au.	MX
coopers.com.au.	MX
www.ivoclarvivadent.com.au.	AAAA
www.qualifi.com.au.	A
solutions.konicaminolta.com.au.	A
dymocks.com.au.	AAAA
www.tenseconds.com.au.	A
www.mypsp.com.au.	A
cal.fmc.flinders.edu.au.	AAAA
www.swimaustralia.org.au.	AAAA
www.celcius.com.au.	A
www.paperwings.com.au.	AAAA
www.novartis.com.au.	AAAA
europa.ccgs.wa.edu.au.	A
www.theleadagency.com.au.	A
mail2.on2k.com.au.	A
history.sa.gov.au.	A
www.mamagreen.com.au.	AAAA
www.rheem.com.au.	AAAA
barbequesgalore.com.au.	AAAA
www.tweednews.com.au.	A
www.rmk.com.au.	A
www.busesrus.com.au.	AAAA
tsfn.com.au.	MX
girigiri.gbrmpa.gov.au.	A
vic.australis.com.au.	MX
energyservices.com.au.	MX
www.conifer.com.au.	AAAA
www.artsa.com.au.	A
proactiveservices.com.au.	A
norstar.com.au.	MX
cpcp.com.au.	A
www.citigroup.com.au.	A
crawco.com.au.	MX
wycliffe.nsw.edu.au.	MX
www.darlingtonbeach.com.au.	A
www.rawfish.com.au.	A
www.labanda.com.au.	A
dolls.ebay.com.au.	A
media.watoday.com.au.	AAAA
www.clan.org.au.	AAAA
mail.anet.com.au.	A
north-shore-times.whereilive.com.au.	A
www.cupcakesbyk.com.au.	A
www.canada.embassy.gov.au.	AAAA
housing.wa.gov.au.	A
www.nationaltimes.com.au.	A
www.sportingmind.com.au.	A
www.citizenship.gov.au.	AAAA
light.sa.gov.au.	MX
www.hushpuppies.com.au.	AAAA
sothertonsgladstone.com.au.	MX
www.orange.nsw.gov.au.	A
ddhgraham.com.au.	AAAA
www.ecofibre.com.au.	A
dominic.tas.edu.au.	MX
www.penguinclassics.com.au.	AAAA
www.jasa.net.au.	AAAA
nw.com.au.	MX
www.genetics.edu.au.	AAAA
overclockers.com.au.	AAAA
grazia.ninemsn.com.au.	AAAA
mail.solo.com.au.	A
frasermotors.com.au.	MX
www.rubbishremoval.com.au.	AAAA
gcap.com.au.	A
mail.thehostingroom.com.au.	A
www.onlinespecialists.com.au.	AAAA
www.americancollege.com.au.	AAAA
www.golfaustralia.com.au.	A
student.unimelb.edu.au.	MX
threeq.com.au.	MX
www.hr.ecu.edu.au.	A
www.man.com.au.	A
www.multiquip.com.au.	A
knightfrank.com.au.	AAAA
www.thelocavore.com.au.	A
lsdb.com.au.	AAAA
mail.presentationstudio.com.au.	AAAA
www.hydeneng.com.au.	A
ns.uca.org.au.	AAAA
www.musichead.com.au.	AAAA
cqnet.com.au.	MX
mercerbell.com.au.	MX
mediastream.f2.com.au.	A
www.offcoursegolf.com.au.	A
www.jobnet.com.au.	A
bunbury.wa.gov.au.	MX
assets.qantascu.com.au.	A
www.sciencealert.com.au.	AAAA
corporate.wesfarmers.com.au.	MX
peterdawson.com.au.	MX
www.bushranger.com.au.	A
mailproxy.txc.net.au.	A
www.brisbane.coc.edu.au.	A
www.amnesia.com.au.	AAAA
oimapp3.usq.edu.au.	A
www.nps.org.au.	AAAA
mail.argentaust.com.au.	A
ns1.hostworks.net.au.	A
sentrix.com.au.	MX
danny.oz.au.	A
prdwagga.com.au.	MX
www.neutrogena.com.au.	AAAA
calm.wa.gov.au.	MX
mail.netaccess.com.au.	A
bonus.newcastle.edu.au.	AAAA
www.3squadron.org.au.	A
www.australia.net.au.	A
filmlocations.com.au.	A
www.paceline.com.au.	A
paypaperbills.postbillpay.com.au.	A
maxwell.com.au.	A
mbc.qld.edu.au.	MX
www.staticice.net.au.	AAAA
www.livingcreatively.com.au.	A
www.phoenixcontact.com.au.	A
nsw.chariot.net.au.	A
newsstore.smh.com.au.	A
www.pastelpretenders.com.au.	A
mta01.polyfone.com.au.	A
beautyinabottleat.blogspot.com.au.	A
signet.com.au.	A
ceres.org.au.	AAAA
three.com.au.	A
wesley.vic.edu.au.	MX
qantas.com.au.	AAAA
www.titaninteractive.com.au.	A
www.jonathan-m-shiff.com.au.	AAAA
www.yourmovies.com.au.	A
www.autocheck.com.au.	A
epochtimes.com.au.	MX
curriculum.edu.au.	AAAA
eyeswidebay.com.au.	A
www.robmagee.com.au.	A
www.chalet.net.au.	AAAA
mail.hlbnsw.com.au.	A
www.quadeye.com.au.	A
www.wheelersbooks.com.au.	A
spotontransport.com.au.	MX
extranet.ymca.net.au.	AAAA
www.div.net.au.	A
congressrental.com.au.	A
knfilters.com.au.	A
primas.com.au.	MX
axa.com.au.	MX
exchange.wmaa.asn.au.	A
yahoo.net.au.	MX
www.xha.com.au.	AAAA
www.wacom.com.au.	AAAA
www.cec.health.nsw.gov.au.	AAAA
tsagroup.com.au.	A
www.kpl.com.au.	AAAA
www.franks.com.au.	AAAA
www.worldwide.com.au.	A
iphonecases.com.au.	A
slide.com.au.	A
www.alliance.org.au.	AAAA
www.thyroid.org.au.	AAAA
www.qubooks.com.au.	A
www.koukei.com.au.	AAAA
maxwinkless.com.au.	MX
indoorbootcamp.com.au.	AAAA
www.foodandtravel.com.au.	A
bankprint.com.au.	MX
forum.iprimus.com.au.	AAAA
mx.coastal.net.au.	A
www.helpontheway.com.au.	AAAA
mytelecom.com.au.	A
www.antiaircraft.org.au.	A
mail.voipex.com.au.	AAAA
theartscentre.com.au.	AAAA
eck.net.au.	A
today.com.au.	MX
www.vnv.org.au.	A
altis.com.au.	MX
mail.nlc.sa.gov.au.	A
cpscu.com.au.	MX
hollywoodnails.com.au.	AAAA
artcivil.com.au.	A
veil.net.au.	A
www.ambitengineering.com.au.	AAAA
perthnow.newsltd.com.au.	MX
www.megajam.com.au.	A
smtp1.csg.com.au.	A
www.sofresh.com.au.	A
www.galleryimage.com.au.	A
www.classicrockfm.com.au.	AAAA
www.dietlicious.com.au.	AAAA
kathmandu.com.au.	MX
www.latinhub.com.au.	AAAA
policy.monash.edu.au.	A
mail.webpublications.com.au.	A
www.peppersformalwear.com.au.	A
www.givenchy.com.au.	AAAA
phcn.vic.gov.au.	MX
no-vacancy.com.au.	AAAA
www.ducati.com.au.	A
doggy.com.au.	MX
aph.gov.au.	AAAA
metrotas.com.au.	AAAA
newsroom.uts.edu.au.	AAAA
mail.harmansetts.com.au.	A
www.adcentre.com.au.	A
libertas.bigblog.com.au.	AAAA
www.hmri.net.au.	AAAA
www.workshopped.com.au.	AAAA
www.pv.unsw.edu.au.	AAAA
www.issr.uq.edu.au.	A
johnhughes.com.au.	MX
www.cyberdesignworks.com.au.	A
www.sherryspestcontrol.com.au.	A
www.heraldsun.com.au.	AAAA
www.atherstone.com.au.	A
www.lunapalace.com.au.	AAAA
www.cleancruising.com.au.	AAAA
smtp1.ssg.org.au.	A
www.barnes.com.au.	A
www.seotherapy.com.au.	AAAA
www.imagingpathways.health.wa.gov.au.	A
tga.gov.au.	A
pelenoy.com.au.	A
www.surfculture.com.au.	A
mail.ion.com.au.	A
news-server.bigpond.net.au.	MX
www.therecord.com.au.	AAAA
jewellery.ebay.com.au.	AAAA
calida.com.au.	A
sure.com.au.	A
boystown.com.au.	MX
student.uws.edu.au.	AAAA
statelymoorings.com.au.	A
www.krispykreme.com.au.	A
mx2.decipha.firstwave.com.au.	A
www.hellenika.com.au.	A
ccli.com.au.	MX
www.nowbaking.com.au.	AAAA
radlogic.com.au.	MX
ccd.com.au.	A
www.robomaid.com.au.	A
ns2.instanthosting.com.au.	A
eurekamin.com.au.	AAAA
ns1.iexec.com.au.	AAAA
qmr.wanet.com.au.	A
mail8.quadrahosting.com.au.	A
bestandless.com.au.	AAAA
www.mssfibre.com.au.	AAAA
www.brightonmetrohotel.com.au.	A
zebrasite.com.au.	MX
dbmagazine.com.au.	MX
themotorreport.com.au.	AAAA
www.greenerbins.com.au.	A
kilvington.vic.edu.au.	AAAA
stageandscreen.com.au.	MX
images.f2.com.au.	AAAA
www.vetfind.com.au.	A
www.gelish.com.au.	AAAA
ipbno.tcif.telstra.com.au.	A
www.capitaloffice.com.au.	AAAA
mail.pm-partners.com.au.	A
harber.com.au.	MX
www2.slv.vic.gov.au.	AAAA
awesomefighter.com.au.	MX
www.glowpaint.com.au.	A
www.bamboobikes.com.au.	AAAA
b.au.	A
act.gov.au.	A
jjh.com.au.	MX
mediadownload2.f2.com.au.	A
www.racket.net.au.	A
origin.net.au.	MX
mailext.dragnet.com.au.	A
www.acss.org.au.	A
www.australia.gov.au.	AAAA
www.ans.org.au.	AAAA
www.microsoftstore.com.au.	A
brauer.vic.edu.au.	A
www.mercedes-benz.com.au.	AAAA
spacefurniture.com.au.	AAAA
www.companiesnow.com.au.	AAAA
www.xxxxalehouse.com.au.	AAAA
www.bigbrownbox.com.au.	A
www.kidcyber.com.au.	A
www.zcars.com.au.	A
professional.ansell.com.au.	AAAA
aquascene.com.au.	A
conferenceaction.com.au.	MX
excelior.com.au.	AAAA
in2cricket.com.au.	AAAA
www.racismnoway.com.au.	AAAA
sinclairs.com.au.	A
www.planetentertainment.com.au.	A
rmit.net.au.	A
www.infomedia.com.au.	AAAA
switchit.com.au.	MX
vosgroup.com.au.	MX
www.rci.com.au.	A
www.drmav.com.au.	A
uip.com.au.	MX
www.lifeionizer.com.au.	AAAA
michael.tyson.id.au.	AAAA
motorcycle-insurance.com.au.	AAAA
penrhos.wa.edu.au.	MX
garrards.com.au.	MX
ggs.wa.edu.au.	AAAA
ns.highway1.com.au.	AAAA
smarthomesystems.com.au.	MX
www.ccusa.com.au.	AAAA
www.seahavennoosa.com.au.	A
regencycustoms.com.au.	MX
services.net.au.	MX
arcbs.redcross.org.au.	MX
deyalexander.com.au.	A
www.portergeo.com.au.	A
www.fabrizia.com.au.	A
www.japaneselifestyle.com.au.	A
mail2.sta.nsw.gov.au.	A
ns1.hosting-services.net.au.	AAAA
freehills.com.au.	MX
pelikanartline.com.au.	A
ambit.com.au.	MX
silverton.com.au.	A
www.projectperfect.com.au.	AAAA
macedon-ranges-leader.whereilive.com.au.	AAAA
www.cesa.catholic.edu.au.	AAAA
www.filemaker.com.au.	AAAA
allianceairlines.com.au.	A
ips.cap.anu.edu.au.	A
ro.ecu.edu.au.	AAAA
emmanuel.wa.edu.au.	MX
www.architecture.com.au.	AAAA
property.mitula.com.au.	AAAA
www.foundationforchildren.com.au.	A
health.gov.au.	AAAA
www.cut2shreds.com.au.	A
websurf.net.au.	MX
www.onedeepdesign.com.au.	AAAA
cranbournemusic.com.au.	A
thegreenman.net.au.	AAAA
sportsco.com.au.	MX
teravin.com.au.	MX
metric.com.au.	MX
italianmedia.com.au.	AAAA
austcolled.com.au.	A
www.afrbiz.com.au.	A
randw.com.au.	A
www.polka.com.au.	A
k-sbms.com.au.	A
www.treasury.act.gov.au.	AAAA
ats-pacific.com.au.	MX
www.skynewsbusiness.com.au.	AAAA
mym.com.au.	A
conceptual.net.au.	MX
www.airforce.gov.au.	A
www.cawcr.gov.au.	AAAA
www.click2.com.au.	A
www.vipstaff.com.au.	AAAA
www.kerastase.com.au.	A
www.budgetpilotsupplies.com.au.	AAAA
mail.retinaaustralia.com.au.	A
www.dd3.com.au.	A
ucw.com.au.	MX
quality-assurance.com.au.	AAAA
www.teach-overseas.com.au.	AAAA
www.wealthguard.com.au.	A
www.shopmania.com.au.	A
www.careernav.com.au.	A
exchange.apilifestyle.com.au.	A
actmf01.gohosting.com.au.	A
livingwaters.wa.edu.au.	MX
hume.vic.gov.au.	MX
samantharobinson.com.au.	AAAA
www.caniborrowthat.com.au.	AAAA
www.nextcar.com.au.	A
www.sweetoncupcakes.com.au.	A
apndigital.com.au.	A
metlam.com.au.	A
salesconsultants.com.au.	A
www.holcombe.net.au.	A
mx6.cdu.edu.au.	A
www.aircheck.net.au.	AAAA
www.ozresort.com.au.	AAAA
enabled.com.au.	AAAA
belowthebelt.com.au.	MX
erwraasdafsf.blogspot.com.au.	A
www.artsconnect.com.au.	AAAA
hi-speed.com.au.	MX
mx.dancrai.com.au.	A
www.pi.csiro.au.	A
www.mnb.com.au.	A
lifestyle.hipages.com.au.	A
www.promotionproducts.com.au.	AAAA
www.motorhomeconversion.com.au.	AAAA
www.baybeans.com.au.	AAAA
www.clockworkremovals.com.au.	AAAA
travelrite.com.au.	A
csiro.au.	MX
rjv.com.au.	MX
thenormanby.com.au.	MX
www.3dfuture.com.au.	AAAA
www.motogp.com.au.	AAAA
plasticsurgery.org.au.	MX
marrickville.nsw.gov.au.	AAAA
www.australianconstructionfocus.com.au.	AAAA
possolutions.com.au.	MX
www.nik.com.au.	AAAA
www.legsnbreasts.com.au.	AAAA
www.hyperweb.com.au.	AAAA
backyardfarmer.com.au.	AAAA
watercorporation.com.au.	AAAA
tafe.nsw.edu.au.	MX
dmgradio.com.au.	AAAA
lipton.com.au.	A
www.seniorsinfo.nsw.gov.au.	A
bridalregistry.i-do.com.au.	A
www.investsmart.com.au.	A
scotspgc.qld.edu.au.	MX
mail.portfolio-planning.com.au.	A
www.janjucsurfclub.com.au.	A
campbelltown.nsw.gov.au.	MX
mail.ombo.nsw.gov.au.	A
www.sev.com.au.	AAAA
windalpark.com.au.	A
www.annemiles.com.au.	A
homepages.tig.com.au.	A
www.unisanet.unisa.edu.au.	AAAA
www.koalanet.com.au.	A
themarsbar.com.au.	A
www.juneesoutherncross.com.au.	AAAA
www.mysmartshopper.com.au.	A
chc.edu.au.	AAAA
www.pittstreetmall.com.au.	AAAA
joannenova.com.au.	AAAA
karcultas.sa.edu.au.	MX
wollongong.nsw.gov.au.	A
watersedge.com.au.	MX
economics.adelaide.edu.au.	AAAA
swimming.org.au.	A
www.apostrophe.com.au.	A
www.dermalogica.com.au.	AAAA
www.honeymoonguide.com.au.	A
www.beeradvice.com.au.	A
www.couriermail.com.au.	AAAA
www.thepersonnelconnection.com.au.	AAAA
www.isana.org.au.	A
mcmedia.com.au.	A
mail.uvtc.net.au.	A
fabonline.com.au.	A
www.photographytips.com.au.	A
www.footy.com.au.	A
mx8.det.wa.edu.au.	A
www.graphisoft.com.au.	A
homemail.com.au.	MX
www.schoolofpuppetry.com.au.	AAAA
www.lifelonglearning.com.au.	A
www.springgullyfoods.com.au.	A
www.eventexperts.com.au.	AAAA
www.messengernews.com.au.	A
www.sydneyservicedapartments.com.au.	A
www.cengage.com.au.	AAAA
mail.glenmar.com.au.	A
www.buyfridges.com.au.	AAAA
www.hoskingindustries.com.au.	A
mdlaw.com.au.	A
www.southernent.com.au.	AAAA
www.1800gotjunk.com.au.	A
mailfilter.hotelhelpdesk.com.au.	A
www.asid.net.au.	A
universalmagazines.com.au.	MX
datalink.com.au.	AAAA
begacheese.com.au.	AAAA
cityresidential.com.au.	A
www.theimperial.com.au.	A
becampbell.com.au.	MX
powderroom.com.au.	A
www.tsl.org.au.	A
bugs.bio.usyd.edu.au.	AAAA
www.nicholsons.net.au.	A
www.siliconchip.com.au.	A
aciar.gov.au.	A
www.theedge961.com.au.	A
www.section8.com.au.	AAAA
www.franki.com.au.	AAAA
www.badboy.com.au.	AAAA
boxhill.org.au.	MX
www.wormald.com.au.	AAAA
www.bussq.com.au.	A
harrisscarfe.com.au.	MX
www.mysoul.com.au.	AAAA
smallbusiness.brisbanetimes.com.au.	A
ords.com.au.	A
www.amitie.com.au.	A
careergateway.monash.edu.au.	A
iinet.com.au.	MX
mail.amaq.com.au.	A
ceda.com.au.	AAAA
circlework.com.au.	AAAA
contextmedia.com.au.	MX
www.spiritual.com.au.	A
www.interiordecorating.com.au.	A
mycology.adelaide.edu.au.	A
guests.com.au.	MX
student.uts.edu.au.	MX
nioka.com.au.	A
suntory.com.au.	MX
soulaustralia.com.au.	A
thelearningworkshop.com.au.	MX
macnamara.id.au.	MX
ymt.com.au.	MX
www.hyperweb.com.au.	A
hardlaw.com.au.	MX
safilo.com.au.inbound10.mailprotector.com.au.	A
acl.arts.usyd.edu.au.	A
www.mimdesign.com.au.	A
majoryachtservices.com.au.	MX
whk.com.au.	MX
meditation.org.au.	AAAA
mhl.nsw.gov.au.	A
drawingbook.com.au.	A
565.lasoo.com.au.	AAAA
www.goldensandsbellydance.com.au.	A
bigwheels.net.au.	A
lilyjackson.com.au.	A
rslcom.net.au.	MX
mx2.powercreations.com.au.	A
iseek.com.au.	A
clpr.com.au.	MX
www.eastwesteng.com.au.	A
macmahon.com.au.	MX
antispam2.idl.net.au.	A
www.fastercashloans.com.au.	AAAA
poports.com.au.	A
shop.mja.com.au.	A
dha.gov.au.	AAAA
www.playbasedlearning.com.au.	AAAA
www.herbalessences.com.au.	A
manly-daily.whereilive.com.au.	A
assfencing.com.au.	A
www.homeless.org.au.	A
images.safm.com.au.	AAAA
www.yellowtrace.com.au.	A
www.studiosamba.com.au.	AAAA
www.sewtogether.com.au.	A
www.extremerc.com.au.	A
minitech.com.au.	A
www.mv2.com.au.	AAAA
staff.ask.sydney.edu.au.	A
buxton.com.au.	AAAA
vcd.vic.edu.au.	A
livescores.ninemsn.com.au.	A
rocla.com.au.	MX
port-phillip-leader.whereilive.com.au.	A
www.labonline.com.au.	A
www.skillsone.com.au.	A
zener.com.au.	A
www.sarcastic.com.au.	AAAA
www.studentconnection.unsw.edu.au.	A
www.itee.uq.edu.au.	AAAA
scea.wa.edu.au.	MX
winsoft.net.au.	MX
cardno.com.au.	MX
www.ffm.com.au.	AAAA
www.hennabodyart.com.au.	AAAA
www.cme.mq.edu.au.	AAAA
acv.com.au.	A
www.austest.com.au.	AAAA
heartfoundation.org.au.	MX
static5.cartoonnetwork.com.au.	A
uq.edu.au.	MX
thorn.com.au.	A
magswitch.com.au.	A
cgs.act.edu.au.	MX
www.myplace.edu.au.	A
www.newscience.com.au.	A
balmain.com.au.	A
mx1.chariot.com.au.	A
mx2.astc.firstwave.com.au.	A
cairnsairport.com.au.	MX
mail.sydneyshowers.com.au.	A
www.redredred.com.au.	AAAA
walford.asn.au.	MX
churchesofchrist.org.au.	MX
www.biogenidec.com.au.	AAAA
www.hypervibe.com.au.	A
superrugby.tipping.theage.com.au.	A
www.nursingreview.com.au.	A
www.taxrefunds.com.au.	AAAA
www.minx.com.au.	A
therock.com.au.	A
merchantpartners.com.au.	MX
www.koalaforklifts.com.au.	A
shop.elvis.com.au.	A
mylicence.sa.gov.au.	AAAA
mail.apws.com.au.	AAAA
stirling.wa.gov.au.	MX
www.discountprinting.com.au.	A
secure.digitalcamerawarehouse.com.au.	A
cairnssunsetcruises.com.au.	AAAA
www.intertec.com.au.	A
www.tours.net.au.	A
www.accommodation.uq.edu.au.	AAAA
mail.asatiles.com.au.	A
dhw.wa.gov.au.	MX
richmond0.barrettgroup.com.au.	A
rdaust.com.au.	MX
www.naqtechnology.com.au.	AAAA
swan.wa.gov.au.	A
www.alp.org.au.	A
egypttravel.com.au.	AAAA
www.students.mq.edu.au.	AAAA
vanguard.com.au.	AAAA
staff.scu.edu.au.	AAAA
tsn.com.au.	MX
jagspares.com.au.	MX
mail.landpartners.com.au.	A
rbs.org.au.	MX
iress.com.au.	A
www.happymeal.com.au.	AAAA
www.stpaulscathedral.org.au.	A
novita.org.au.	MX
cdn.cbsi.com.au.	AAAA
www.fjhsolutions.com.au.	AAAA
www.foxwebdesign.com.au.	A
redrockleisure.com.au.	AAAA
mail.whytehall.com.au.	A
www.australia-times.com.au.	A
praxa.com.au.	MX
unilever.com.au.	AAAA
barnardos.org.au.	A
www.etas.com.au.	A
minyos.its.rmit.edu.au.	AAAA
www.focusminerals.com.au.	AAAA
mail2.frednet.com.au.	AAAA
liquorlegends.com.au.	MX
www.cohunu.com.au.	AAAA
www.starconfig.com.au.	A
www.stuckinside.com.au.	A
www.iibit.edu.au.	AAAA
minyos.its.rmit.edu.au.	A
media.hsv.com.au.	A
psy.uwa.edu.au.	MX
bigpond.com.au.	A
bicorp.com.au.	A
tracking.offerfactory.com.au.	AAAA
www.silkn.com.au.	A
rentpay.com.au.	MX
mrphp.com.au.	MX
officemax.com.au.	MX
www.surecom.com.au.	AAAA
www.atvdlstanley.com.au.	A
skillscentre.com.au.	A
dns1.uwa.edu.au.	AAAA
nssa.com.au.	AAAA
dvd.myfun.com.au.	A
nadc.wsi.tafensw.edu.au.	A
antiquitea.com.au.	AAAA
caama.com.au.	MX
wideband.net.au.	MX
acclaimparks.com.au.	AAAA
jabberwock.slq.qld.gov.au.	A
pathway.net.au.	A
ecoseekers.com.au.	A
www.sydneyskydivers.com.au.	A
publicityworks.com.au.	MX
www.davidtoddphotography.com.au.	AAAA
syddns1.unisys.com.au.	A
mail.bellp.com.au.	A
www.stackspancakebar.com.au.	AAAA
lbw.com.au.	MX
hickory.com.au.	A
www.metrobd.com.au.	AAAA
echidna.id.au.	MX
www.minx.com.au.	AAAA
www.recruitmentdirectory.com.au.	AAAA
otl.side.wa.edu.au.	A
flexigroup.com.au.	A
alti.com.au.	A
