thumbs2.ebaystatic.com.	AAAA
mountaineerpublishing.com.	MX
www.mediafire.com.	A
www.freemarket.com.	A
google.com.	A
developers.facebook.com.	A
ads.smowtion.com.	A
solofarandulaperu.blogspot.com.	A
m.addthisedge.com.	A
ssl.google-analytics.com.	A
www.reuters.com.	A
mail.sodoit.com.	A
www.download.windowsupdate.com.	A
csi.gstatic.com.	A
www.apple.com.	A
www.haacked.com.	A
www.jujiaow.com.	A
api.facebook.com.	A
dns.msftncsi.com.	A
sageinc.com.	A
google.com.	A
developers.facebook.com.	A
api.twitter.com.	A
pub.reggaefrance.com.	A
an.d.chango.com.	A
www.gossiponthis.com.	AAAA
mail.mastertex.com.	A
www.foxsportsla.com.	A
education.idoneos.com.	AAAA
api.twitter.com.	A
developers.facebook.com.	A
i2.ytimg.com.	A
edge.quantserve.com.	A
hi-in.facebook.com.	A
www.facebook.com.	A
es-es.facebook.com.	A
quakerfabric.com.	MX
es-es.facebook.com.	A
andrewsullivan.com.	MX
i499.photobucket.com.	A
www.hotelelreymoro.com.	A
www.microsoft.com.	A
www.gonelocal.com.	A
rad.msn.com.	A
img.apnanalytics.com.	A
apps.facebook.com.	A
www.shareyouritems.com.	A
www.man-engines.com.	AAAA
nothirst.com.	A
asktoolbar.weather.com.	A
img.youtube.com.	A
www.facebook.com.	A
s1.wp.com.	A
s.youtube.com.	A
gma.yahoo.com.	A
lh3.ggpht.com.	A
fistintheair.com.	A
hackingetico.com.	AAAA
static.xvideos.com.	A
blog.mobango.com.	A
st.chatango.com.	A
marketingdesdelaromana.blogspot.com.	A
www.juegospara.com.	A
toolbarqueries.google.com.	A
chinamoly.com.	MX
different-love.foroactivo.com.	A
data-recovery-free-help.blogspot.com.	A
darkanime.mforos.com.	AAAA
i2.ytimg.com.	AAAA
dmse.com.	MX
mediacdn.disqus.com.	A
laplumadebarro.blogspot.com.	A
www.google.com.	A
client66.dropbox.com.	A
t2.gstatic.com.	A
cdn.mediafire.com.	A
tsuki-yaoi.blogspot.com.	A
imap.gmail.com.	A
mychemhelena.obolog.com.	A
www.humorpower.com.	A
eu4.stvid.com.	A
www.ct-7ob.com.	A
video.xnxx.com.	A
ssl.gstatic.com.	A
www.cinemanow.com.	A
developers.facebook.com.	A
butovo.com.	A
www.birdseye.com.	A
abajate.blogspot.com.	A
www.blackberry.com.	A
ib.adnxs.com.	A
email.com.	MX
www.facebook.com.	A
mt1.googleapis.com.	A
l.yimg.com.	A
t7.tagstat.com.	A
ucs.query.yahoo.com.	A
i4.ytimg.com.	A
rylandhomes.com.	MX
google.com.	A
sfdr-cisd.com.	MX
goodereader.disqus.com.	A
1496354998.mail.outlook.com.	A
landrover.tagworldwide.com.	A
i4.ytimg.com.	A
download884.avast.com.	A
hi-in.facebook.com.	A
translate.google.com.	A
www.google.com.	A
tpc.googlesyndication.com.	A
blog.seattlecoffeegear.com.	AAAA
noticias.lainformacion.com.	A
www.facebook.com.	A
descargararesgratis.disqus.com.	A
redirector.c.youtube.com.	A
i366.photobucket.com.	A
api-read.facebook.com.	A
docs.google.com.	A
m.addthisedge.com.	A
img.mediaplex.com.	A
login.live.com.	A
afrozeprinting.com.	A
youtube-ui.l.google.com.	MX
apps.facebook.com.	A
www.google.com.	A
sponsoredcdn.speedbit.com.	AAAA
www.xn--cabaasmazamitla-1qb.com.	A
developers.facebook.com.	A
idealcalor.com.	MX
clients1.google.com.	A
a355.phobos.apple.com.	A
mail2lucky.com.	MX
www.facebook.com.	A
api.twitter.com.	A
el.y8.com.	A
dlpiper.com.	MX
canadianislamiccongress.com.	A
gmaseven.blogspot.com.	AAAA
tijuana-kei.com.	A
www.reverbnation.com.	A
i3.ytimg.com.	A
www.fotosrarasgratis.com.	A
enblogs.com.	A
g.ceipmsn.com.	A
suggestqueries.google.com.	A
www.msftncsi.com.	AAAA
api.facebook.com.	A
liduvinacarrera.blogspot.com.	A
encrypted-tbn1.google.com.	A
need2bfit.com.	A
www.iegallery.com.	A
googlehosted.l.googleusercontent.com.	MX
www.youtube.com.	A
view.atdmt.com.	A
mail.landbank.com.	A
cuda.csystems.com.	A
mail.kwreferred.com.	A
www.google.com.	A
www.macgeneration.com.	A
www.youngcloseup.com.	AAAA
www.youtube.com.	A
c0551612.cdn.cloudfiles.rackspacecloud.com.	A
safebrowsing-cache.google.com.	A
www.facebook.com.	A
xodusgroup.com.	MX
www.winamp.com.	A
www.facebook.com.	A
images03.olx-st.com.	A
theflatland.com.	A
www.mmaaxx.com.	A
gswebhost.com.	A
r1rk9np7bpcsfoeekl0khkd2juj27q3o-a-fc-opensocial.googleusercontent.com.	A
s3.amazonaws.com.	A
www.google.com.	A
css.wlxrs.com.	A
audio-sv5-t1-1.pandora.com.	AAAA
www.facebook.com.	A
www.swtorguidehq.com.	A
www.youtube.com.	A
blog.gypsy05.com.	A
u20.eset.com.	A