www.michaelmurray.ca.	AAAA
racki.ca.	MX
electron.phys.dal.ca.	MX
tridentexploration.ca.	MX
mailwall.transx.ca.	A
www.rheostatics.ca.	A
www.instantcover.ca.	A
www.different-strokes.ca.	A
web.mala.bc.ca.	A
www.kia.ca.	A
accesscom.ca.	A
www.naturalizer.ca.	A
www.competitionbureau.gc.ca.	A
pruneau.ca.	MX
jobboomcc.canoe.ca.	A
mbsi.ca.	MX
accc.ca.	MX
husky81.stmarys.ca.	A
www.rogerdmoore.ca.	A
arts.ubc.ca.	MX
f2.flyertown.ca.	A
www.city.toronto.on.ca.	A
www.sonystyle.ca.	AAAA
videtron.ca.	MX
mail.woods.qc.ca.	A
mx2.douglas.bc.ca.	A
www.rqhealth.ca.	A
edu.csrdn.qc.ca.	MX
mail3.uqam.ca.	AAAA
www.laurieremtm.ca.	A
sasktel.ca.	A
www.sauder.ubc.ca.	A
oceanography.dal.ca.	A
crtc.gc.ca.	A
totem.ca.	A
www.laterre.ca.	A
greenparty.ca.	A
mail.cementation.ca.	A
reseau.crdi.ca.	A
youtube.ca.	A
www.howlies.ca.	A
pubs.aina.ucalgary.ca.	AAAA
performance.rcmusic.ca.	A
www.historica-dominion.ca.	A
www.smithmusic.ca.	A
mx2.jumpit.ca.	A
www.science.mcmaster.ca.	A
lung.ca.	A
littleloon.ca.	A
bassi.ca.	MX
www.eesti.ca.	A
hermes.ulaval.ca.	A
currentstudents.upei.ca.	A
central.acadiau.ca.	A
gamemaster.qc.ca.	MX
cab.gov.on.ca.	A
pif.ca.	MX
www.sunmedia.ca.	A
bedbugsinfo.ca.	A
www.womenscycling.ca.	A
www.teachers.ab.ca.	A
naulin.ca.	MX
uottawa.ca.	MX
mshsmtp100.mountsinai.ca.	A
www.metazen.ca.	A
www.cps.ca.	A
mx.win.terago.ca.	A
www.canaco.ca.	A
dcpa.ca.	MX
www.sma-canada.ca.	AAAA
www.swc-cfc.gc.ca.	A
halifax.ca.	MX
library.uvic.ca.	A
corinthianenergy.ca.	A
oirp.carleton.ca.	A
smarttechs.ca.	MX
omnitv.ca.	A
www.fsh.uqam.ca.	A
mail2.ecs.qc.ca.	A
qmjhl.uploads.mrx.ca.	A
vdn.ca.	MX
xmradio.ca.	A
fcms.concordia.ca.	A
brianlucas.ca.	MX
globi.ca.	MX
www.maplebear.ca.	A
kvhs.nbed.nb.ca.	AAAA
norml.ca.	A
philosophy.uwaterloo.ca.	A
cdn.ci3.yp.ca.	AAAA
www.playmobil.ca.	A
learn.utoronto.ca.	A
brokerlink.ca.	A
www.weddingsbypaul.ca.	A
northwest.ca.	A
www.testfreaks.ca.	A
www.recherche.uqam.ca.	A
bell.ca.	MX
nothing.ca.	MX
kingston.cfc.dnd.ca.	A
www.pointdebasculecanada.ca.	A
tldsb.on.ca.	MX
www.cnib.ca.	A
lapresse.ca.	MX
www.crossroadsobgyn.ca.	A
www.communitech.ca.	A
mx2.torontohousing.ca.	A
oise.utoronto.ca.	A
www.indev.ca.	AAAA
oakville.ca.	MX
www.clc.ca.	AAAA
www.audi.ca.	A
www.capp.ca.	AAAA
psalm121.ca.	A
mike.heller.ca.	AAAA
mail.alliedpower.ca.	A
www.servus.ca.	A
www.shawhosting.ca.	A
info.51.ca.	AAAA
www.ece.uvic.ca.	A
mailsec1.bzinc.ca.	A
www.homedics.ca.	A
www.sd68.bc.ca.	A
myrru.royalroads.ca.	A
osap.gov.on.ca.	AAAA
www.q104.ca.	A
www.coachoutletonline.ca.	A
mercury.uwinnipeg.ca.	A
plug-in.bestbuy.ca.	AAAA
mail.shaw.ca.	AAAA
mangaworld.ca.	A
www.cstudies.ubc.ca.	A
clarkhall.ca.	MX
rewards.ebay.ca.	A
www.fungalguide.ca.	A
web3.uottawa.ca.	A
www.theargus.ca.	AAAA
www.thismustbetheplace.ca.	A
stemnet.nf.ca.	A
webmail.canadacouncil.ca.	A
cdn.iphoneincanada.ca.	A
www.legalfrontiers.ca.	A
homesnanaimo.ca.	A
ipac2.vpl.ca.	A
c.airg.ca.	A
www.uppercasegallery.ca.	AAAA
cogego.ca.	MX
boxartshow.ca.	A
www.steamwhistle.ca.	A
mail.lynchmob.ca.	A
blog.roseflash.ca.	A
pilot.ca.	MX
www.northisland.ca.	A
masterpromotions.ca.	A
www.zonerecompenses.ca.	A
m.ticketmaster.ca.	A
www.peachland.ca.	A
www.rollergirl.ca.	AAAA
nikolaidis.ca.	A
www.mcmasterchildrenshospital.ca.	A
www.sonymusic.ca.	A
www.lethbridge.ca.	A
mx2.uottawa.ca.	A
homehardware.ca.	A
accu-rate.ca.	MX
www.deondesigns.ca.	A
s3.translation.weblite.ca.	A
comox.ca.	MX
stjoes.ca.	MX
powergate.ca.	MX
thedominion.ca.	MX
www.caferacer.ca.	AAAA
leatherking.ca.	A
www.ssc.uwo.ca.	A
recreation.yorku.ca.	A
provigo.ca.	MX
www.canadianlawsite.ca.	A
autotrader.ca.	AAAA
www.aquaculture.ca.	A
acsta.ab.ca.	MX
www.jcdurand.ca.	A
hotmail.ca.	MX
mail2.services.netscape.ca.	A
www.eagle.ca.	A
www.lamediation.ca.	A
omegle.ca.	A
pi.library.yorku.ca.	AAAA
www.kidney.ca.	AAAA
csmb.qc.ca.	MX
www.agilemontreal.ca.	A
assemblyonline.assembly.ab.ca.	A
www.empr.gov.bc.ca.	A
mail.badawy.ca.	A
www.actra.ca.	A
mail.soccercan.ca.	A
ahamedia.ca.	AAAA
bellaliant.ca.	MX
prologix.ca.	MX
cmhc.ca.	A
playbackonline.ca.	AAAA
www.costcoconnection.ca.	A
alcera.ca.	MX
bertram.ca.	MX
www.forces.ca.	A
www.pixelfxstudios.ca.	AAAA
www.laws.justice.gc.ca.	A
nonprofits.accesscomm.ca.	A
yellowpages.ca.	A
alzheimer.ca.	MX
www.neuroanatomy.ca.	A
dekla.ca.	A
www.carj.ca.	A
redirack.ca.	MX
conservative.ca.	A
bennettjones.ca.	A
larco.ca.	MX
rheinmetall.ca.	MX
punjabipost.ca.	A
suntv.canoe.ca.	A
www.monarc.ca.	A
www.beardowear.ca.	AAAA
wildlaw.ca.	MX
www.ehmac.ca.	AAAA
wire.arts.ubc.ca.	A
www.itabc.ca.	A
cgm.cs.mcgill.ca.	MX
mri.gouv.qc.ca.	MX
www.cocoboudoir.ca.	A
www.timingthemarket.ca.	AAAA
netscape.aol.ca.	A
dreger.ca.	MX
www.livesmartbc.ca.	A
www.melrosejewelers.ca.	AAAA
communiques.gouv.qc.ca.	A
agora.ulaval.ca.	A
acadiau.ca.	MX
www.bedirect.ca.	A
artsalumni.ryerson.ca.	MX
www.kijiji.ca.	AAAA
oxfam.ca.	A
gpwealth.ca.	A
smtp.sentex.ca.	A
keyano.ca.	A
mx.gta.terago.ca.	A
www.cibc.ca.	AAAA
igoogle.ca.	AAAA
www.ottawaartgallery.ca.	A
mitek.ca.	MX
www.dfsdirect.ca.	AAAA
moodle.queensu.ca.	A
www.qrgarage.ca.	A
www.miele.ca.	A
bolt.lakeheadu.ca.	A
is.mgh.mcgill.ca.	AAAA
www.niagarafalls.ca.	A
www.shoal.ca.	A
www.jacobite.ca.	A
acdi-cida.gc.ca.	A
mail.minnikin.ca.	A
rrfdc.on.ca.	MX
www.vernon.ca.	A
www.hantsjournal.ca.	A
blog.canoe.ca.	A
www.sonicnation.ca.	A
dvds.shop.ebay.ca.	AAAA
engr.uvic.ca.	MX
www.betrayer.ca.	A
mail.tribute.ca.	A
onyx.ca.	A
www.openrealestate.ca.	A
www.lush.ca.	A
mail.amica.ca.	A
finning.ca.	MX
powerauthority.on.ca.	MX
med2020.ca.	A
www.keywordspy.ca.	A
mmf.mb.ca.	MX
mail2.yrp.ca.	A
www.kfpl.ca.	A
www.garlandcanada.ca.	A
www.vstore.ca.	A
www.moodle.uqam.ca.	A
slam.canoe.ca.	AAAA
www.dhl.ca.	A
www.elektra.ca.	A
www.conjecture.ca.	AAAA
ps3.cdn.autotrader.ca.	AAAA
wiband.ca.	A
ntp2.cmc.ec.gc.ca.	A
nbnet.nb.ca.	MX
www.mathstat.dal.ca.	A
d.mx.utoronto.ca.	A
www.eventneighborhood.ca.	A
ssmu.mcgill.ca.	MX
quebec.craigslist.ca.	A
www.michaelsflooring.ca.	A
www.bloggingcanadians.ca.	AAAA
fr.acer.ca.	A
smtp.cegepsth.qc.ca.	A
www.idrc.ca.	A
www.sbcentre.ca.	A
nf.sympatico.ca.	MX
www.gopad.ca.	A
collinssafety.ca.	A
bluebolt.ca.	A
toysrus.ca.	A
mail1.caasco.ca.	A
citizenship.microsoft.ca.	A
cinema.concordia.ca.	A
www.swap.ca.	A
www.gospeli.ca.	A
localwork.ca.	AAAA
www.sympatico.ca.	A
visionmedical.ca.	A
smtp.hmssoftware.ca.	A
smtp.did.qc.ca.	A
www.form.services.micc.gouv.qc.ca.	A
fr.ca.	A
ontario.ca.	MX
ontarioseedbank.ca.	A
www.missional.ca.	A
fci.on.ca.	MX
alumni.carleton.ca.	A
www.dabbler.ca.	A
www.tctrail.ca.	A
www.edu.pe.ca.	AAAA
blog.fedcan.ca.	AAAA
www.ipolitics.ca.	A
www.crfa.ca.	A
loblaw.ca.	MX
123photo.ca.	MX
mailwizard.proplus.ca.	A
fr.canoe.ca.	A
aptn.ca.	MX
www.gazette.uottawa.ca.	AAAA
www.defisante.ca.	A
mail.gov.nf.ca.	MX
mx2.lino.sympatico.ca.	A
youngadultcancer.ca.	A
bushwhackers3.djartsgames.ca.	A
mail.wightman.on.ca.	A
www.nightlife.ca.	AAAA
filter1873.zerospam.ca.	A
royallpage.ca.	A
blog.alexblack.ca.	A
team1040.ca.	MX
ns1.dal.ca.	A
www.bcscta.ca.	A
www.mtvvma.ca.	AAAA
www.midnightwhispers.ca.	AAAA
www.tcu.gov.on.ca.	A
www.drewmarshall.ca.	AAAA
www.cim.mcgill.ca.	AAAA
bolen.bc.ca.	MX
www.mei.gov.on.ca.	AAAA
mail2.mip.ca.	A
auto-spec.ca.	MX
www.sneakpeek.ca.	AAAA
www.reptox.csst.qc.ca.	A
www.districtofwestkelowna.ca.	AAAA
cps.ca.	AAAA
observer.quesnelmuseum.ca.	A
richtech.ca.	A
theadguys.ca.	A
www.arts.uwaterloo.ca.	AAAA
www.taker.ca.	A
nwood.ns.ca.	A
augusta.ca.	A
serecon.ca.	A
mailtor.banquelaurentienne.ca.	MX
cigem.ca.	MX
www.truehealth.ca.	A
dialone.ca.	MX
www.cambridge.ca.	A
health-evidence.ca.	A
www3.publicationsduquebec.gouv.qc.ca.	A
mx5.nait.ca.	A
www.onetouch.ca.	A
uwindsor.ca.	MX
saatchi.ca.	MX
www.learnarabic.ca.	AAAA
images.mec.ca.	AAAA
up.411.ca.	A
www.peoplesvoice.ca.	A
uwlm.ca.	MX
registrar.yorku.ca.	A
ftp.nirb.ca.	AAAA
www.canadaba.ca.	AAAA
loudpipe.ca.	A
www.medi-systeme.ca.	A
tourismnewbrunswick.ca.	AAAA
mb.bluecross.ca.	MX
www.annaolson.ca.	A
psjobs-emploisfp.psc-cfp.gc.ca.	A
www.ed.gov.nl.ca.	A
www.iphoneringtones.ca.	AAAA
concordia.ab.ca.	MX
ddsm.ca.	MX
media3.onf.ca.	AAAA
map.toronto.ca.	A
huskies.usask.ca.	A
www.cbcshop.ca.	A
www.localwork.ca.	A
www.globex2000.ca.	A
indianclaims.ca.	A
www.throng.ca.	AAAA
ecsl2010.softwarelibre.ca.	A
vhost.dido.ca.	AAAA
www.individual.utoronto.ca.	A
www.occdsb.on.ca.	A
www.janssen.ca.	AAAA
www.enfieldrifles.ca.	AAAA
tdsb.on.ca.	A
mess.gouv.qc.ca.	A
sonora.mala.bc.ca.	MX
stmikes.utoronto.ca.	A
mailgate3.tru.ca.	A
i.411.ca.	A
ididit.ca.	MX
www.militaryminds.ca.	A
industrydynamics.ca.	A
cdn.mediative.ca.	AAAA
mp.siriuscanada.ca.	A
symptico.ca.	MX
mx1.digicom.ca.	A
newmarket.ca.	MX
www.bloggingcanadians.ca.	A
bhncdsb.edu.on.ca.	MX
yahoo.shoptoit.ca.	AAAA
vipgolf.ca.	A
innovexpert.ca.	MX
acciona.ca.	A
www.canadianhomehealthcareservices.ca.	A
sublink.ca.	AAAA
herbalmagic.ca.	MX
tomkin.ca.	A
mddep.gouv.qc.ca.	MX
ford.ca.	MX
excite.ca.	MX
mftsolutions.ca.	MX
fr.simplyhired.ca.	A
konicaminolta.ca.	A
sjhc.london.on.ca.	MX
cwb.ca.	A
tmsd.mb.ca.	MX
acciona.ca.	MX
smtp2.sunnybrook.ca.	A
www.dealstreet.ca.	A
fmcsd.ab.ca.	MX
meridiancu.ca.	MX
imagesource.ca.	MX
sd73.bc.ca.	A
mediom.qc.ca.	MX
scmze013.ssan.egs-seg.gc.ca.	A
mx1.lino.sympatico.ca.	A
eatlink.ca.	MX
mail.stars.ca.	A
www.robotshop.ca.	A
www.equestre.ca.	A
whois.cira.ca.	A
lifestyle.sympatico.ca.	A
www.grannys.ca.	A
www.mmm.ca.	A
www.rds2.ca.	A
www.jamiekennedy.ca.	A
tigroup.ca.	MX
www.inmax.ca.	A
my.mun.ca.	A
conecti.ca.	A
www.thesmart.ca.	A
www.myfit.ca.	AAAA
www.edmontonkiosk.ca.	A
www.standguard.ca.	A
ilko.ca.	MX
www.bravo.ca.	A
kayden.ca.	A
www.websearchguide.ca.	A
www.bedbathandbeyond.ca.	AAAA
crowncookware.ca.	A
www.arabesquedance.ca.	A
mftsolutions.ca.	A
www.nr.gov.nl.ca.	A
www.vdn.ca.	A
sgdsb.on.ca.	MX
www.cihr-irsc.gc.ca.	A
www.metcam.navcanada.ca.	A
tiff07.ca.	A
hiebelleville.ca.	MX
yorku.ca.	MX
www.schulich.yorku.ca.	A
www.alcoa.ca.	A
songwriters.ca.	A
www.mrsfields.ca.	A
nedco.ca.	MX
artjames.ca.	MX
citywars.ca.	A
ir.lib.sfu.ca.	A
www.anti-social.ca.	A
www.starauctions.ca.	AAAA
pco.gc.ca.	MX
cscdgr.on.ca.	MX
webtrends2.collectionscanada.gc.ca.	A
mail.squamish.ca.	A
www.jobs.utoronto.ca.	AAAA
iaah.ca.	MX
groupedsl.ca.	A
www.sproing.ca.	A
smtp2.sfl.qc.ca.	A
mw01.intellix.ca.	A
ns.sympatico.ca.	MX
www.randstadprofessionals.ca.	A
cupehub1.cupe.ca.	A
www.cribe.ca.	A
www.speekeezy.ca.	A
www.healthcare.ubc.ca.	A
www.upscale.utoronto.ca.	A
mail.vistek.ca.	A
flyerland.ca.	A
mississauga.ca.	MX
www.tngc.ca.	A
abnet.ca.	MX
lives.ca.	A
www.bcee.concordia.ca.	A
xcelco.on.ca.	MX
www.rcip-chin.gc.ca.	A
vancouver.24hrs.ca.	A
medical-imaging.utoronto.ca.	AAAA
loki.chebucto.ca.	A
kamloops.olx.ca.	A
magna.on.ca.	A
dvd-rental.ca.	AAAA
redirack.ca.	A
waterloo.ca.	MX
suite22.ca.	MX
www.metronews.ca.	AAAA
www.bellnet.ca.	A
mail.pecounty.on.ca.	A
www.cdtv.ca.	A
www.forces.ca.	AAAA
passport.ca.	MX
dns.internic.ca.	A
mail.fdcanada.ca.	A
specialsections.siteseer.ca.	AAAA
www.dmm.ca.	A
wcmprod2.ucalgary.ca.	A
fuseimages.weather.ca.	A
mail.hable.ca.	A
www.ukrainewoman.ca.	A
wastedtalent.ca.	A
mail.mnp.ca.	A
www.londonarts.ca.	A
bbn.ca.	MX
aquatica.ca.	MX
www.lportepilot.ca.	A
mediacorp.ca.	A
coastalfinancial.ca.	A
www.sergiy.ca.	A
oicr.on.ca.	MX
er.uqam.ca.	MX
forces.ca.	A
dhs.ca.	MX
www.field.ca.	A
mx.myaccess.ca.	A
www.matthewgraves.ca.	A
mjolk.ca.	A
mixes.dabears.ca.	AAAA
mx1.netsell.ca.	A
austinrealty.on.ca.	MX
excelsior.ycdsb.ca.	AAAA
en.lhjmq.qc.ca.	AAAA
esfpa.ca.	MX
healthandfitness.sympatico.ca.	A
www.kitchener.ca.	A
ugm.ca.	A
fmam.ca.	A
krug.ca.	MX
scottpaper.ca.	A
www.teambuy.ca.	A
nunavut.kijiji.ca.	A
boompa.ca.	MX
qcislands.ca.	MX
cargotools.aircanada.ca.	A
www.intercultures.ca.	A
mx.mcgill.ca.	A
gpe.concordia.ca.	A
dlrsmtp1.toyota.ca.	A
stemnet.nf.ca.	MX
www.musicounts.ca.	A
physwww.mcmaster.ca.	A
www.hemis.ca.	A
www.media-awareness.ca.	A
gosonic.ca.	A
mail.una.ab.ca.	A
www.credifin.ca.	A
www.comedygold.ca.	A
www.informalberta.ca.	A
www.sphere.bc.ca.	A
www.tommy.ca.	A
radio-canada.ca.	AAAA
mx2.uqac.ca.	A
mail.town.grimsby.on.ca.	A
davejones.ca.	A
mx5.manitoba-ehealth.ca.	A
mail.lweb.ca.	A
totalexperience.ca.	A
www.frapru.qc.ca.	A
www.pco-bcp.gc.ca.	A
web.uwaterloo.ca.	A
archives.cbc.ca.	AAAA
blueline.ca.	AAAA
cornerbrook.kijiji.ca.	A
prn.bc.ca.	MX
blog.muschamp.ca.	A
artrubicon.ca.	A
fuzzz.gaulin.ca.	A
www.rat.ca.	A
www.topblogs.ca.	A
vdldodgeball.ca.	A
www.playingitsafe.ca.	A
www.jobs77.ca.	A
torontojobs.ca.	MX
gx.ca.	MX
www.cheekymonkey.ca.	AAAA
www.privcom.gc.ca.	A
www.slimfast.ca.	A
knightsbridge.ca.	MX
feedback.ebay.ca.	AAAA
www1.sympatico.ca.	A
medicassurance.ca.	MX
email.leadcentre.ca.	A
neb-one.gc.ca.	MX
keystonematrix.ca.	A
www.crateandbarrel.ca.	A
unitz.ca.	A
management.uottawa.ca.	MX
ms.umanitoba.ca.	MX
ip1.bloorview.ca.	A
www.careers.ualberta.ca.	AAAA
www.bccrc.ca.	A
chapters.indigo.ca.	AAAA
lubricants.petro-canada.ca.	AAAA
onside.ca.	MX
www.iar.ubc.ca.	A
spamit.usask.ca.	A
www.trendwhore.ca.	A
www.dailybreadcafe.ca.	A
www.paintblog.ca.	A
www.sony.monstermediaworks.ca.	A
ads.basal.ca.	A
www.elegantwedding.ca.	A
ebay.ca.	AAAA
army.ca.	AAAA
bilan.usherbrooke.ca.	A
svc.sympatico.ca.	A
www.bellnet.ca.	AAAA
www.mun.ca.	AAAA
theworkroom.ca.	AAAA
mail.sentinelgroup.ca.	A
www.zoology.ubc.ca.	AAAA
f.mx.utoronto.ca.	A
freemasonry.bcy.ca.	AAAA
www.leadnow.ca.	A
www.ednet.ns.ca.	A
images.boatdealers.ca.	AAAA
sdc-dsc.gc.ca.	A
seccotine.risq.qc.ca.	AAAA
atlcat.ca.	MX
vectorconsulting.ca.	MX
www.ugrad.math.ubc.ca.	A
www.ticketmaster.ca.	AAAA
www.redroseflorist.ab.ca.	A
promail.ca.	MX
www.court.nl.ca.	A
clocktower.ca.	A
www.mynameiskate.ca.	AAAA
laws.justice.gc.ca.	AAAA
canadatourism.ca.	MX
www.michaelmurray.ca.	A
students.utoronto.ca.	AAAA
fastcooking.ca.	AAAA
targetvacations.ca.	AAAA
abbynet2.sd34.bc.ca.	A
waterlife.nfb.ca.	A
barracuda2.cupe.ca.	A
img.amazon.ca.	AAAA
scf.sk.ca.	MX
garfield.cs.mun.ca.	A
kitchener.craigslist.ca.	A
www.virtualmuseum.ca.	A
scmze013.ssan.egs-seg.gc.ca.	AAAA
ptaff.ca.	A
humber.ca.	A
elcamino.ca.	MX
www.elduris.ca.	A
person.yasni.ca.	A
cbcmobileproductions.ca.	A
fadden.ca.	MX
www.unesco.ca.	AAAA
nucorp.ca.	MX
www.cacr.math.uwaterloo.ca.	A
www.garage.ca.	A
cyberscol.qc.ca.	A
li.acsi.ca.	A
mx1.centrichealth.ca.	A
www.uqtr.uquebec.ca.	A
aussiepetmobile.ca.	MX
starbuilding.mb.ca.	MX
mail.lansolutions.ca.	A
www.campbellsci.ca.	A
frontierhonda.ab.ca.	A
disney.ca.	A
streetforce.ca.	A
community.royalroads.ca.	A
www.mscc.ca.	AAAA
www.cyqm.ca.	AAAA
www.suzuki.ca.	A
exclaim.ca.	A
scmze005.ssan.egs-seg.gc.ca.	A
mail.wightman.ca.	A
person.yasni.ca.	AAAA
baseballhalloffame.ca.	MX
www.candeal.ca.	A
yah00.ca.	MX
lifemadedelicious.ca.	AAAA
www.calgarykiosk.ca.	A
www.evangelicalfellowship.ca.	A
ag.ca.	MX
nudgedesign.ca.	A
factorydirect.ca.	MX
lowetide.ca.	AAAA
bookthug.ca.	MX
www.ubcpress.ca.	AAAA
pecounty.on.ca.	MX
cei2008.ca.	MX
yogafortoday.ca.	MX
unb.ca.	A
i2-store.walmart.ca.	A
mailscan.amdsb.ca.	A
kler.ca.	MX
www.cmhc.ca.	A
filter1869.zerospam.ca.	A
mail.fortymile.ab.ca.	A
futech.ca.	MX
www.zenmma.ca.	A
www.muug.mb.ca.	A
mx1.nplus.ca.	AAAA
www.peelregion.ca.	AAAA
snowbomber.ca.	A
www.noelberry.ca.	AAAA
avant-garde.ca.	A
virtuo.ca.	MX
www.ucs.mun.ca.	AAAA
trimar.ca.	MX
image.cellphones.ca.	A
www.roguecanada.ca.	A
www.chemistry.mcmaster.ca.	A
blogs.sfu.ca.	A
jcc.hhsc.ca.	MX
br-inc.ca.	MX
www.findusfast.ca.	A
dalgrad.dal.ca.	A
www.technomarine.ca.	A
www.fiddlehead.ca.	A
www.rcip-chin.gc.ca.	AAAA
www.spiegelschrift.ca.	A
mashteuiatsh.ca.	A
www.csc-scc.gc.ca.	AAAA
togethertoronto.ca.	A
orijen.ca.	A
mail.carlton.ca.	A
oise.utoronto.ca.	MX
www.amnesty.ca.	AAAA
manhattans.ca.	A
m.en.canoe.ca.	A
www.sunnewsnetwork.ca.	A
brandsaver.ca.	A
dcmusic.ca.	MX
cssd.ab.ca.	MX
www.cma.ca.	A
stroma.ca.	MX
www.airfrance.ca.	A
esdnl.ca.	MX
designplan.ca.	A
downes.ca.	MX
mail.fitnessdepot.ca.	A
mail2.wcb.ab.ca.	A
yummymummyclub.ca.	A
elevatorlady.ca.	A
www.nurturedblog.ca.	A
www.racetalk.ca.	A
rapidimpact.ca.	A
www.naisa.ca.	AAAA
foxed.ca.	A
mail.magma.ca.	A
www.catsa.gc.ca.	A
qwerty.ca.	MX
wwwxml.gouv.qc.ca.	A
advertising.microsoft.ca.	A
www.digitalreview.ca.	A
www.foreurs.qc.ca.	A
www.flyforless.ca.	A
ea.ca.	MX
www.motherhoodcanada.ca.	A
www.hanna.ca.	A
wildfire.sunbowl.ca.	A
weirdscience.ca.	A
www.bourses.umontreal.ca.	A
www.francisationenligne.gouv.qc.ca.	A
www.endcancer.ca.	A
www.cancercare.on.ca.	AAAA
bellnet.ca.	MX
chem.utoronto.ca.	MX
bloomberg.nursing.utoronto.ca.	A
www.collectionscanada.gc.ca.	A
comoxvalley.en.craigslist.ca.	AAAA
lightspeed.bc.ca.	AAAA
gaspesie.kijiji.ca.	AAAA
wilsonwelldrilling.ca.	A
econewsbits.greencoloredglasses.ca.	AAAA
mail1.cnsc-ccsn.gc.ca.	A
www.brocktv.ca.	A
photoshare.shaw.ca.	AAAA
makeababy.ca.	A
www.it-careers.ca.	A
elmwood.on.ca.	MX
www.xm411.ca.	A
collegeahuntsic.qc.ca.	A
www.norquest.ca.	A
jnm.ca.	MX
web2.uvcs.uvic.ca.	A
www.ccca.ca.	A
www.therealm.ca.	AAAA
www.thechocolatedoctor.ca.	AAAA
www.ulife.utoronto.ca.	A
hometrust.ca.	MX
uoguelph.ca.	MX
mailserver2.hydro.mb.ca.	A
www.financialresources.uottawa.ca.	AAAA
www.free-translations.ca.	A
cria.ca.	MX
www.entertainmentlawyers.ca.	A
economics.ca.	MX
mailserver.cep.ca.	A
bibl.ulaval.ca.	MX
nemq2p02.standardlife.ca.	A
engr.mun.ca.	MX
www.bcchildrens.ca.	A
www.cbif.gc.ca.	A
www.stclaircollege.ca.	A
gap.ca.	MX
www.rbg.ca.	A
weather.ca.	A
gauntlet.ucalgary.ca.	MX
www.gojobs.gov.on.ca.	A
mailserv.ccrsb.ednet.ns.ca.	A
www.rogersonenumber.ca.	AAAA
ugweb.cs.ualberta.ca.	A
wrdsb.on.ca.	A
recherched.gouv.qc.ca.	A
dmpeli.mcmaster.ca.	AAAA
ontarioliberal.ca.	MX
www.bananarepublic.ca.	A
www.betheboss.ca.	A
www.johnsonpublications.ca.	A
www.autoshow.ca.	A
www.lgvrf.ca.	A
bpa.ca.	MX
www.riv.ca.	A
www.kin.ucalgary.ca.	A
www.unfolding.ca.	A
www.dancepooh.ca.	A
www.royallepage.ca.	AAAA
www.x929.ca.	A
www.ic.gc.ca.	A
groupwise.cgaspesie.qc.ca.	A
prevnet.ca.	A
mail.waysideco.ca.	A
viarail.ca.	MX
www.lcmedia.ca.	A
pics.forecaster.ca.	A
focus.ca.	MX
www.yaoi.ca.	A
www.sweetretreat.ca.	A
www.jonlin.ca.	A
www.pli.ca.	A
mcgill.ca.	MX
www.saic.gouv.qc.ca.	A
mail2.pagenet.ca.	A
www.thestar.ca.	A
redcross.ca.	MX
homesnanaimo.ca.	MX
pnls.lib.sk.ca.	MX
footlocker.ca.	A
rahb.ca.	MX
www.mocca.ca.	A
sciserv1.uwaterloo.ca.	A
www.sunlife.ca.	A
gdg.ca.	A
www.nbs-enb.ca.	A
ns.sympstico.ca.	A
camps.mabel.ca.	A
www.insidevancouver.ca.	AAAA
it.sheridanc.on.ca.	A
kristian.ca.	MX
webmail.umen.ca.	A
www.criminaldefenceottawa.ca.	A
le12ejoueur.ca.	A
ccra-adrc.gc.ca.	MX
filter2210.zerospam.ca.	A
www.yahoo.ca.	MX
flash.lakeheadu.ca.	A
www2.telefilm.gc.ca.	A
royalroads.ca.	MX
bcou.ca.	A
main.library.utoronto.ca.	AAAA
www.legion.ca.	A
www.frj.qc.ca.	A
www.globalknowledge.ca.	A
www.windmobile.ca.	AAAA
www.nbc.ca.	AAAA
viv.ebay.ca.	A
mx1.trentu.ca.	AAAA
mazenstudio.ca.	A
sharinginhealth.ca.	A
bss.on.ca.	A
www.randomhouse.ca.	A
watarts.uwaterloo.ca.	MX
risingabove.ca.	MX
mail.globaladvisors.ca.	A
ampersandinc.ca.	A
www.untv.ca.	A
www.ryersonrams.ca.	AAAA
csvdc.qc.ca.	MX
carloc.ab.ca.	A
gscs.sk.ca.	MX
www.newpaige.ca.	A
www.civil.uwaterloo.ca.	A
filter1799.zerospam.ca.	A
diabolo.ca.	A
play.psych.mun.ca.	A
queensu.ca.	MX
supl.wireless.bell.ca.	A
www.monavis.ca.	A
www.thalassemia.ca.	A
wynndel.ca.	MX
www.russharvey.bc.ca.	A
cim.mcgill.ca.	A
www.newliberal.ca.	A
help.indigo.ca.	A
www.g4s.ca.	A
www.globaltrekkers.ca.	A
api-sp.radio-canada.ca.	A
mycanadore.ca.	MX
iaw.on.ca.	A
interiorhealth.ca.	MX
www.uvicbookstore.ca.	A
moving.ca.	MX
mail.infonet.ca.	A
chly.ca.	A
clublink.ca.	A
www.mydreamwedding.ca.	AAAA
crwsystems.mb.ca.	A
www.lexisnexis.ca.	A
www.neutrality.ca.	A
bestbuy.ca.	AAAA
www.vitevitevite.ca.	A
accounts.google.ca.	AAAA
jackbrooks.ca.	A
www.dominicarpin.ca.	A
elizabethmacdonald.ca.	A
chsrf.ca.	A
9bit.qc.ca.	MX
staff.argyll.epsb.ca.	AAAA
county.simcoe.on.ca.	MX
yellowpages.ca.	AAAA
chemistry.uwinnipeg.ca.	A
sageit.ca.	A
s4.flyerland.ca.	AAAA
www.sqm.ca.	A
mail.me2u.ca.	A
www.hardtimes.ca.	A
www.homesanddesign.ca.	A
epsb.ca.	A
www.ltb.gov.on.ca.	A
actuary.ca.	A
privacy.nb.ca.	A
www.photowonk.ca.	A
www.ppoc.ca.	AAAA
www.departement.ca.	A
navigators.ca.	MX
stthomasu.ca.	MX
epcor.ca.	MX
almostperfect.ca.	MX
www.carrieres.gouv.qc.ca.	AAAA
skip.ssb.yorku.ca.	AAAA
gvrd.bc.ca.	MX
artsalumni.ryerson.ca.	A
windsorite.ca.	A
www.avcanada.ca.	AAAA
deltapolice.ca.	MX
