www.studioninedots.nl.	A
ispacsearch.nuffic.nl.	A
gate99.nl.	MX
umail.leidenuniv.nl.	A
spem.msm.nl.	A
www.mijntelegraaf.nl.	A
lombok.nl.	MX
www.marktplaats.nl.	A
www.abb.nl.	A
scholsdelange.nl.	MX
mrouter.wirehub.nl.	A
old-and-young.aff.mature.nl.	A
ns04.2is.nl.	A
www.feanonline.nl.	A
srv1.pediwell.nl.	A
www.stertil.nl.	A
search.iisg.nl.	A
www.afm.nl.	A
cysonet.nl.	A
www.dik.nl.	A
batiment.nl.	A
abh.nl.	MX
wbadvies.nl.	AAAA
boonedam.nl.	MX
abiword.snt.utwente.nl.	A
zijn.samenresultaat.nl.	AAAA
umm.nl.	MX
www.speurders.nl.	A
mx01.ebo-mkb.nl.	A
mx3.mail.tiscomhosting.nl.	A
taxi-nuis.nl.	MX
www.nighteye.nl.	A
hetparkhuis.nl.	MX
concepts.nl.	A
cob.nl.	MX
immoselekt.nl.	A
www.jouwpagina.nl.	AAAA
tupwanders.nl.	AAAA
static.greetz.nl.	AAAA
www.houseboathotel.nl.	A
td.klm.nl.	MX
hoenderdaal-fasteners.nl.	MX
geldergroep.nl.	MX
shopex.nl.	MX
mx1.eemlandinternet.nl.	A
lifestyle.overzicht.nl.	A
www.freeoneslive.nl.	A
stage.yourscene.nl.	A
www.wintertuin.nl.	A
wits.nl.	MX
aol.nl.	MX
www.seniorplaza.nl.	A
annefrank.nl.	MX
www.beursgorilla.nl.	AAAA
mail1.versatel.nl.	A
bluefish.openoffice.nl.	A
raym.deds.nl.	A
mrsmail.maars.nl.	A
www.reflectionit.nl.	A
global-producers.nl.	A
www.dwightschultzfansite.nl.	A
mailgateway2.nlr.nl.	A
www.computertotaal.nl.	A
fallback.soko.nl.	A
voorraad.wheelerdelta.nl.	A
www.nederlandse-ambassade.nl.	A
www.ebook.nl.	A
www.computerwoorden.nl.	A
schaatsen.nl.	AAAA
filter1.onlinespamfilter.nl.	MX
www.lauradekker.nl.	A
www.os3.nl.	A
www.oneworld.nl.	A
beekerveld.nl.	MX
intranet.tudelft.nl.	A
content.omroep.nl.	A
www.ritzsite.demon.nl.	A
x264.nl.	MX
www.bergmankliniek.nl.	A
vacatures.donkiz.nl.	A
chtig.nl.	MX
worldonline.nl.	MX
www.reizen-paleis.nl.	AAAA
onsbrabantnet.nl.	A
blog.rackdoll.nl.	A
www.astronieuws.nl.	A
mailgateway1.vict.nl.	A
www.spel.nl.	AAAA
www.freeones.nl.	A
xda.androidrevolution.nl.	A
www.drx-design.nl.	AAAA
www.reactnewmedia.nl.	A
www.steendrukmuseum.nl.	A
stream.airpeace.nl.	AAAA
games17.xs4all.nl.	A
www.interglot.nl.	AAAA
dakvanbrabant.nl.	AAAA
www.peta.nl.	A
hotmail.nl.	MX
smtp01.prezent.nl.	A
www.easyswitch.nl.	A
karladams.nl.	MX
www.eclectro.nl.	A
arends.nl.	MX
www.addmissions.nl.	A
www.spirit24.nl.	A
uvh.nl.	MX
fbto.nl.	MX
uradio.utwente.nl.	MX
www.gemeentemuseum.nl.	A
www.annazoekt.nl.	A
proxy.spele.nl.	A
webmail.vivent.nl.	A
www.nujij.nl.	AAAA
zwolle.hyves.nl.	A
www.feanonline.nl.	AAAA
dsv.nl.	MX
test.nl.	AAAA
vancleef-consultancy.nl.	A
www.maastrichtuniversity.nl.	A
sgrarr.drp.minjus.nl.	MX
club.bnn.nl.	AAAA
debian.mirror.cambrium.nl.	A
www.lancome.nl.	A
homepage.tudelft.nl.	A
82-204-11-50.dsl.bbeyond.nl.	A
mailhost.dla.nl.	A
www.wayuki.nl.	A
www.bart.nl.	AAAA
www.nis5.nl.	A
pers.vhall.nl.	MX
pub.consumentenbond.nl.	A
www.dutch-passion.nl.	A
www.aldaevents.nl.	A
www.astro.rug.nl.	AAAA
www.different.nl.	AAAA
www.pompecenter.nl.	A
www.perennialfilm.nl.	A
cache.hyves.nl.	A
www.persgroepadvertising.nl.	AAAA
imail.nl.	A
tegenlicht.vpro.nl.	AAAA
oce.nl.	A
mail.rocgilde.nl.	A
mxscan04.masc.nl.	A
www.gtagames.nl.	A
www.caveo.nl.	A
mx.is.nl.	A
rocflevoland.nl.	MX
breman.nl.	MX
media.nu.nl.	A
holland-safari.nl.	A
em-mx.euronet.nl.	A
gwebcache.linuxonly.nl.	A
www.dccg.nl.	A
ns3.siteview.nl.	AAAA
notariskantoordijkstra.nl.	A
dewidt.nl.	A
mx1.systux.nl.	A
relay.nl.	MX
lavafilm.nl.	MX
www.hillspet.nl.	A
www.woordjesleren.nl.	A
spamfilter1.phylax.nl.	A
aon.nl.	MX
roundsquare.nl.	MX
mail.vimotec.nl.	A
vicari.nl.	A
vertalen.nl.	A
leiden.hyves.nl.	A
pixel.nl.	MX
www.twinmotorcycles.nl.	AAAA
smtp.swets.nl.	MX
www.koffiecenter.nl.	A
www.hotel-hestia.nl.	A
www.zuidencomm.nl.	A
pavoservice.nl.	MX
cjp.nl.	MX
www.baroeg.nl.	A
onlineseminar.dft.nl.	A
adapt.openorbit.nl.	A
nikhef.nl.	MX
4visions.nl.	A
diplodocs.nl.	A
www.mercedes-benz.nl.	A
tiscali.nl.	A
www.refdag.nl.	A
mail.gielissen.nl.	A
mailscan3simac.simacict.nl.	A
server11.firstfind.nl.	A
alva.nl.	A
www.webdesign.nl.	A
www.sexywebcamgirls.nl.	A
www.ifpi.nl.	AAAA
britishschool.nl.	MX
www.nujournaal.nl.	A
www.htcinternational.nl.	AAAA
maps.msn.nl.	A
smtp.komtvanzelfaan.nl.	A
www.fashionscene.nl.	A
www.digitalage.nl.	AAAA
tomvanbakel.punt.nl.	A
www.kijkshop.nl.	A
www.travel2dance.nl.	A
radiobox2.omroep.nl.	AAAA
daxis.nl.	A
jooble.co.nl.	A
www.hetnet.nl.	AAAA
vrouwen.startpagina.nl.	AAAA
mx.mediq.nl.	A
nizw.nl.	A
www.anna-agency.nl.	A
www.hetnet.nl.	A
vandenbergarnhem.nl.	A
magnus.nl.	MX
www.rijksakademie.nl.	AAAA
breda.dichtbij.nl.	A
www.rogierwieland.nl.	A
linux-wless.passys.nl.	AAAA
mx02.foxxl.nl.	A
www.deopendagenkalender.nl.	A
seiko.nl.	MX
malmberg.nl.	MX
www.goedbegin.nl.	AAAA
www.toastiestudio.nl.	AAAA
peter.nl.	A
europa.buienradar.nl.	AAAA
home.humanoid.nl.	A
www.imc.nl.	A
www.elmar.nl.	AAAA
www.onlinesoccermanager.nl.	A
auto-en-vervoer.infonu.nl.	A
vivaria.nl.	A
top25.landingzone.nl.	A
www.platipus.nl.	A
vd.nl.	MX
overmeire.nl.	MX
spamblock2.scalasolutions.nl.	A
pn.nl.	MX
media.insidegamer.nl.	A
tbi.ru.nl.	MX
www.afas.nl.	A
mx2.aplusprofessional.nl.	A
knvb.nl.	A
managementscope.nl.	MX
codi.nl.	MX
grafiplaza.nl.	MX
fallback.netexpo.nl.	A
mail1.interip.nl.	A
student.edith.nl.	MX
kiyak.nl.	MX
www.rejected.nl.	A
bolswarderbedrijven.nl.	MX
tickets.veronicatv.nl.	A
rehue.home.xs4all.nl.	A
www.autoped.nl.	A
newsletter.groupdeal.nl.	A
vara.dmd.omroep.nl.	AAAA
www.knmi.nl.	AAAA
smtp.euronet.nl.	A
leiden.nl.	MX
alternative-music.nl.	A
www.mistermoney.nl.	A
www.sababa.nl.	AAAA
maikelkox.nl.	A
fallback.toschsecurity.nl.	A
widebodyaircraft.nl.	AAAA
pauwenwitteman.vara.nl.	A
apps.fuen.nl.	A
nieuws.mijndomein.nl.	AAAA
toerisme.groningen.nl.	A
www.24oranges.nl.	A
www.aziatischetijger.nl.	A
synthon.nl.	A
www.inflicted.nl.	A
blog.dutchworks.nl.	AAAA
www.fr12.nl.	AAAA
provinciegroningen.nl.	MX
www.uu.nl.	A
www.library.tudelft.nl.	A
www.patriciakaas.nl.	A
blog.qr4.nl.	A
cazemierparket.nl.	A
dumpert.nl.	A
weeronline.nl.	MX
mx01.unet.nl.	A
rivm.nl.	A
www.neerslag.nl.	A
g192082.upc-g.chello.nl.	AAAA
www.trendwerk.nl.	A
peakit.nl.	A
rox.nl.	MX
www.pvv.nl.	AAAA
breda.hyves.nl.	A
nhl.nl.	MX
members.casema.nl.	A
www.thuisbezorgd.nl.	A
spamexperts02.openprovider.nl.	A
www.startpagina.nl.	AAAA
www.aldi.nl.	A
mumc.nl.	MX
fallback.windo.nl.	A
wanadoo.nl.	A
promate.nl.	MX
forumt.nl.	MX
kunst-en-cultuur.infonu.nl.	A
b.mail.aspect-online.nl.	A
discuscentraal.nl.	MX
sushiran.nl.	A
werkenbijhyves.hyves.nl.	AAAA
mx2.vamail.nl.	A
www.at5.nl.	A
communities.zeelandnet.nl.	A
www.endymion.nl.	A
sosinternational.nl.	MX
www.onlinesoccermanager.nl.	AAAA
zhowqhcasivhdjjiewujsurecqdxei.nl.	A
mx1.mail.tiscomhosting.nl.	AAAA
www.cloudtools.nl.	A
www.justanothernerd.nl.	A
www.formdesk.nl.	AAAA
jvanzijl.nl.	MX
vanes.nl.	MX
www.fiat500.nl.	A
gfi.nl.	MX
renascent.nl.	MX
www.voetbalinfo.nl.	AAAA
www.icecat.nl.	AAAA
zideo.nl.	A
www.allradio.nl.	A
tebenet.nl.	A
www.edprojecten.nl.	A
clicks.m4n.nl.	AAAA
taalprof.web-log.nl.	A
lycosmail.nl.	A
deugdenterpstra.nl.	A
nedcar.nl.	MX
neho.nl.	MX
harderwijk.nl.	MX
mail.veldhoven.nl.	A
www.freerecordshop.nl.	A
trietsch.nl.	MX
www.lenen-online.nl.	AAAA
bsmtp.argewebhosting.nl.	A
mail.princi.nl.	A
hhs.nl.	MX
afbeeldingen.apriana.nl.	AAAA
www.iscra.nl.	AAAA
elisabeth.nl.	MX
smtp.feestdj-joost.nl.	A
www.ploegint.nl.	A
comet.nusport.nl.	AAAA
smtp2.accensys.nl.	A
ppsw.rug.nl.	MX
lsa1.quintrics.nl.	A
www.fransefilms.nl.	A
mail.mondialplants.nl.	A
mx1.pauw.nl.	A
www.muldermotoren.nl.	A
maildrop2.enetco.nl.	A
www.planeeths.nl.	A
www.astro.uva.nl.	AAAA
www.medicalfacts.nl.	A
toys.aff.mature.nl.	A
www.powercomponents.nl.	AAAA
www.arthus.nl.	A
www.warrock-hack.nl.	AAAA
static.iphone.ad.nl.	AAAA
www.avdweb.nl.	A
www.voedingscentrum.nl.	A
mxfw1.qdc.nl.	A
waterbedrijfgroningen.nl.	MX
icy.rtl.nl.	A
spamx.easyhosting.nl.	MX
mx1.130.vpo.nl.	A
vsrt.nl.	MX
world4.knightfight.nl.	A
groningen.nl.	A
www.muzzle.nl.	AAAA
web.omroepgelderland.nl.	AAAA
tc.ing.nl.	A
images5.images-speurders.nl.	A
weer.nl.	MX
www.spellengrot.nl.	A
www.henskensfossils.nl.	A
www.trustpilot.nl.	A
haff.nl.	A
telfort.nl.	MX
foto.vkbanen.nl.	AAAA
bruno.nl.	A
deheiden.nl.	A
www.nvus.nl.	AAAA
link.marktplaats.nl.	AAAA
www.matthewsmuziek.nl.	AAAA
secure.mijnwebwinkel.nl.	A
wooldermeent.nl.	MX
www.kaartenhuis.nl.	A
fallback.ezcompany.nl.	A
www.ncrv.nl.	A
app.nos.nl.	AAAA
kranten.kb.nl.	A
images.channels.nl.	A
mail.ockham.nl.	A
absolutefigures.nl.	MX
www.uitvaartcompleetverzekering.nl.	A
asml.nl.	MX
www.nod32.nl.	A
www.wikileaks.nl.	A
www.lenen-online.nl.	A
www.plantbreeding.wur.nl.	A
moremix.hyves.nl.	AAAA
aserving2.speeleiland.nl.	A
sylconiamail.nl.	MX
lim.nl.	MX
www.designwonen.nl.	A
www.theproblemsolver.nl.	AAAA
smtp-cust-01.capgemini.nl.	A
haff.nl.	MX
mailin.planet.nl.	AAAA
www.furion.nl.	A
www.incredibleadventure.nl.	A
mail2.thenetworkfactory.nl.	A
wbadvies.nl.	A
www.cs.unimaas.nl.	A
www.tgpxtreme.nl.	A
smx3.interconnect.nl.	AAAA
www.njobs.nl.	AAAA
www.autowolf.nl.	A
nujij.nl.	A
www.123people.nl.	A
webstats.nedstars.nl.	A
bsmtp.science.nl.	A
www.delta.tudelft.nl.	A
nieuwe.startpagina.nl.	A
filter03.spamservice.nl.	A
www.bligg.nl.	A
www.dutchdesignweek.nl.	A
www.coolcat.nl.	A
www.tonecontrol.nl.	A
darkorbit.speeleiland.nl.	AAAA
www.slm.nl.	A
denachtvlinders.nl.	A
mx.denboeren.nl.	A
haproprofessional.nl.	MX
veronicapublishing.nl.	MX
www.quintrics.nl.	AAAA
forza-utreg.nl.	MX
www.fotomontage.nl.	A
js3.clickzzs.nl.	A
promotools.islive.nl.	AAAA
img.adzs.nl.	A
www.metin2.nl.	AAAA
actieradius.nl.	MX
wlive.nl.	MX
ns02.nexthost.nl.	A
www.renault.nl.	A
zeldenrust.nl.	MX
cesant.nl.	A
www.aupair-world.nl.	A
www.waterstadfm.nl.	A
feedback.ebay.nl.	AAAA
wrd.nl.	MX
www.f1today.nl.	A
www.123dv.nl.	A
webservice-en-gb.weeronline.nl.	A
www.zodiac.nl.	A
www.austinpowers.nl.	A
www.teletop.nl.	A
www.surf2music.nl.	A
gmt.nl.	MX
ajax.nieuwslog.nl.	A
www.reptilesex.nl.	AAAA
mx.vdminet.nl.	A
www.actionradio.nl.	A
mail2.politie.nl.	A
vacatures.trovit.nl.	A
www.ehour.nl.	A
producten.reedbusiness.nl.	A
tribalddb.nl.	MX
www.bma.amsterdam.nl.	A
www.2call.nl.	A
www.localize.nl.	A
www.paspoortinformatie.nl.	AAAA
smtp.lusenet.nl.	A
shop.adidas.nl.	A
www.euronet.nl.	A
mx.facilicom.nl.	A
brabant.nl.	MX
mx1.iris.techniteam.nl.	A
creativity.nl.	A
plan-c.nl.	MX
www.amateur-webcams.nl.	A
static.greetz.nl.	A
nuimages.wapag.nl.	A
www.kieskeurig.nl.	A
helmond.nl.	A
www.radionetherlands.nl.	A
updatepack.nl.	A
www.caiway.nl.	A
server3.firstfind.nl.	A
www.salto.nl.	A
www.columbusmagazine.nl.	A
smartinit.webads.nl.	A
mail2.cofely-gdfsuez.nl.	A
www.hollandcollect.nl.	A
payments.edc-internet.nl.	A
dakvanbrabant.nl.	MX
arag.nl.	MX
www.europages.nl.	A
mareva.nl.	MX
spam.rapide.nl.	A
kender-thijssen.nl.	MX
mail.server3.tobeonline.nl.	MX
fast.mediamatic.nl.	A
ubn.ru.nl.	MX
www.archimon.nl.	A
selfservice.telegraaf.nl.	A
presents.3fm.nl.	A
mx-02.svc.xl-internetservices.nl.	A
dexus.amaze.nl.	A
www.easyapps.nl.	AAAA
www.google.nl.	AAAA
server15.firstfind.nl.	A
favorites.islive.nl.	AAAA
diensten.marktplaats.nl.	A
smtp2.dds.nl.	A
koopjes.marktplaats.nl.	A
www.huidziekten.nl.	A
www.pararius.nl.	A
tg.nl.	MX
nijmedia.nl.	MX
www.huismarseille.nl.	A
pretprieel.nl.	A
www.paperboy.nl.	AAAA
ovc.nl.	MX
www.a-keys.nl.	A
mx3.spothost.nl.	A
content50c2a.omroep.nl.	AAAA
www.classicargarage.nl.	A
www.niverplast.nl.	AAAA
www.innotechwaalwijk.nl.	A
fietsen.123.nl.	MX
ooo.nl.	A
mobilecontaining.nl.	MX
capitolonline.nl.	AAAA
www.myhomeplanet.nl.	AAAA
albertwoest.nl.	A
sex.startpagina.nl.	A
antispam2.easy-services.nl.	A
derooipannen.nl.	MX
www.cybox.nl.	A
www.spel.nl.	A
aanvallen.nl.	A
mauritshuis.nl.	MX
www.coquinaria.nl.	AAAA
www.nciv.nl.	A
www.gratissoftwaresite.nl.	A
pa3aci.nl.	A
feeds.uitzendinggemist.nl.	AAAA
dedicon.nl.	MX
aithon.nl.	MX
www.hac-products.nl.	AAAA
www.nijmegen.nl.	A
nvvb.nl.	MX
alviss.et.tudelft.nl.	A
www.buitensexfilms.nl.	A
dns2.dlpc.nl.	A
onetelnet.nl.	A
www.bootnodig.nl.	A
download-free-smiley-pack.kletsmee.nl.	AAAA
ns.bnamed.nl.	A
www.hyves.nl.	A
www.mion.nl.	A
mail.server3.tobeonline.nl.	A
ns2.siteview.nl.	AAAA
ns1.transip.nl.	AAAA
smtp.amazed.nl.	A
abonnement.flowmagazine.nl.	A
home.hccnet.nl.	A
broekhuisjuweliers.nl.	AAAA
mathworks.nl.	MX
mail01.omni.nl.	A
www.discriminator.nl.	A
www.deappel.nl.	A
pop.xs4all.nl.	AAAA
traffic.ietsmetinternet.nl.	AAAA
www.vanotegem.nl.	AAAA
struik.nl.	A
www.siai-marchetti.nl.	A
www.telegraaf.nl.	AAAA
mail.pridis.nl.	A
groups.google.nl.	AAAA
www.xform.nl.	A
plaatjessilkedaan.hyves.nl.	A
warnierstudio.nl.	MX
mailscan2.vwc-internet.nl.	A
mx1.webinfra.nl.	A
www.managersonline.nl.	AAAA
www.nimiq.nl.	AAAA
www.ebookers.nl.	AAAA
light.m.ad.nl.	AAAA
d57d320a.static.ziggozakelijk.nl.	AAAA
www.voetbalstats.nl.	AAAA
ns2.interconnect.nl.	A
ns2.dlma.nl.	A
hpintermedia.nl.	A
www.maa.nl.	A
www.boekenvandekrant.nl.	AAAA
www.nvva.nl.	A
cartoonmovement.spreadshirt.nl.	A
www.mondriaanfoundation.nl.	A
hosting.ber-art.nl.	A
www.sawadee.nl.	A
www.liveintheliving.nl.	A
nfp-bv.nl.	MX
www.nieuwslijst.nl.	A
dfg.nl.	MX
nomail.ism.nl.	A
www.characters.nl.	A
ns5.easyserver.nl.	A
www.boomerang.nl.	A
geography2.ruhosting.nl.	A
knmg.nl.	MX
vankats.nl.	A
img3.fr12.nl.	AAAA
ims.parool.nl.	A
smtp.systemworks.nl.	A
www.entertainmentexperience.nl.	A
concertzender.nl.	MX
avs.nl.	MX
www.anwb.nl.	A
lb.streamgate.nl.	A
www.sante.nl.	A
ed.maakmedia.nl.	A
zmw.nl.	MX
nidrtd33.nidera.nl.	A
bsmtp.movedmedia.nl.	A
ce.et.tudelft.nl.	A
www.gerritspeek.nl.	A
freeler.nl.	MX
nio.nl.	MX
service.nu.nl.	A
statisch.detelefoongids.nl.	A
www.zappelin.nl.	AAAA
www.dvhn.nl.	AAAA
bergmakelaardij.nl.	MX
nji.nl.	MX
www.jazzindegracht.nl.	A
erotictoyshop.nl.	AAAA
downloads.nl.	MX
geo.vu.nl.	MX
weblogs.nos.nl.	AAAA
www.marktgigant.nl.	A
www.tiesto.nl.	A
mail.ndiepen.nl.	A
static.beursbox.nl.	A
www.smashbits.nl.	A
www.coolblue.nl.	AAAA
www.raym.deds.nl.	A
files.adfactor.nl.	AAAA
fossen.nl.	A
cloud.hitmanpro.nl.	AAAA
blogonline.blog.nl.	A
belastingdienst.nl.	A
www.v2.nl.	A
mmm.samsung.nl.	AAAA
koelewijn.speedlinq.nl.	MX
ns1.globaldns.nl.	A
vuurwerk.nl.	MX
www.analist.nl.	A
blog.cyberwar.nl.	A
www.hoogenlaag.nl.	A
www.sniff.nl.	A
blogsearch.google.nl.	A
www.slimshadyplace.nl.	A
bar2.sb-groep.nl.	A
www.noticias.nl.	A
www.bng.nl.	A
lust.nl.	AAAA
www.belastingdienst.nl.	A
scarlet.nl.	AAAA
planet.sp.nl.	AAAA
cz6.clickzzs.nl.	A
roczeeland.nl.	MX
www.politiek24.nl.	A
m.weeronline.nl.	A
ws15.xn04.provider.nl.	A
home-4.worldonline.nl.	A
mx1.uwexchange.nl.	A
www.onlinereceptenboek.nl.	A
wppa.opajaap.nl.	A
reporter.msn.nl.	AAAA
www.slamhardstyle.nl.	AAAA
www.ajaxshop.nl.	A
nwo.nl.	MX
www.amrathhotels.nl.	A
www.sput.nl.	A
cict.nl.	A
blackhole.dds.nl.	A
www.butel.nl.	A
astro.uu.nl.	A
www.weeronline.nl.	AAAA
redirect.i3d.nl.	A
b.ds1.nl.	AAAA
www.iedereennaakt.nl.	A
static3.trouw.nl.	A
arbexservices.nl.	A
mx3.iacthosting.nl.	A
www.anime-plaza.nl.	AAAA
bar3.sb-groep.nl.	MX
mx1.xel.nl.	A
www.rallymedia.nl.	A
miske.nl.	A
estherkuijpers.nl.	A
www.opiniecentrum.nl.	AAAA
feijenoord.rotterdam.nl.	MX
www.veronicamagazine.nl.	A
dubbelsteynbmw.nl.	MX
enepmx01.amsterdam.nl.	A
mx6.ns.nl.	A
dutch.nl.	MX
www.filmtotaal.nl.	AAAA
www.lexpev.nl.	A
www.dokter.nl.	A
www.sevensheaven.nl.	A
www.weerstation-lemmer.nl.	A
domstaddodgers.nl.	MX
twenteborg.nl.	MX
mxfallback.masc.nl.	A
www.checkitout.nl.	A
www.adstudio.nl.	A
forza-utreg.nl.	A
mx01.netexpo.nl.	A
mailscanner3.hix.nl.	A
rtl.nl.	MX
mailfilter2.databyte-hosting.nl.	A
abeva.nl.	A
www.globalsign.nl.	A
fibre.a2000.nl.	MX
telesport.hyves.nl.	AAAA
messagent.ilsemedia.nl.	A
www.celeb-thumbs.nl.	AAAA
wichm.home.xs4all.nl.	A
taxonomicon.taxonomy.nl.	A
mx02.unet.nl.	A
tros.dmd.omroep.nl.	A
www.samsonite.nl.	A
nospam2.2e2.nl.	A
mailscan4simac.simacict.nl.	A
mx4.linfosyshosting.nl.	AAAA
azu.nl.	MX
data.rtl.nl.	AAAA
www.kiesbeter.nl.	AAAA
vanoverhagen.nl.	A
fallback.stage-entertainment.nl.	A
www.mradult.nl.	A
nl.usenet.nl.	A
bdo.nl.	MX
www.horlogeforum.nl.	A
www.vans.nl.	A
partyon.nl.	MX
ravln.nl.	MX
www.janbik.nl.	A
maastricht.nl.	MX
consunet.nl.	A
fallback.interconnect.nl.	AAAA
lowlandfashion.nl.	A
www.micazu.nl.	A
mail.rbsrv.nl.	A
reviews.vodafone.nl.	A
static.ziggo.nl.	AAAA
www.four05.nl.	A
mx1.carantegroep.nl.	A
www.wieringsoftware.nl.	A
ncmls.ru.nl.	MX
www.msn.nl.	A
forum.jvangent.nl.	A
www.spelletjesapen.nl.	A
www.kemmer.nl.	AAAA
smtp01.onderwijsgroepnoord.nl.	A
smtp.kpnmail.nl.	MX
interieurblog.villadesta.nl.	A
cmsmailrelay.colt-telecom.nl.	A
www.desir.nl.	A
inholland.nl.	MX
subbacultcha.nl.	A
fallback.internet.casemazakelijk.nl.	A
www.kidstop20.nl.	AAAA
www.dickensfestijn.nl.	AAAA
www.bio-bak.nl.	A
scooter-freaks.nl.	MX
tno.nl.	MX
frontoffice.paylogic.nl.	A
www.justanothernerd.nl.	AAAA
www.overtoom.nl.	A
www.goastro.nl.	A
psvreport.nl.	A
www.fi.nl.	A
cgp-01.mail.in2ip.nl.	A
static1.trouw.nl.	AAAA
upcmail.nl.	MX
www.nonumber.nl.	A
media.radio538.nl.	AAAA
kohartog.nl.	MX
www.opajaap.nl.	A
www.wiezoekje.nl.	A
www.winterplaza.nl.	A
www.emgo.nl.	A
rivm.nl.	MX
www.schaatsen.nl.	AAAA
fallback.eatspam.nl.	A
dnb.nl.	A
my.zoover.nl.	AAAA
hoogenboomzuidlaren.nl.	MX
www.uvh.nl.	A
counterpart.nl.	A
gp.home.xs4all.nl.	A
www.nudistbeaches.nl.	AAAA
mnml.nl.	A
kb.plaxis.nl.	A
www.neukjehond.nl.	A
nccw.nl.	MX
studiegids.uva.nl.	A
www.prijsvrij.nl.	A
the-border.nl.	A
webmail.wur.nl.	A
vanleeuwen.nl.	AAAA
ns.kws.nl.	A
scantraxx.tickets.q-dance.nl.	A
fallback1.dcf.nl.	A
www.9292.nl.	AAAA
www.sidn.nl.	A
www.ranesi.nl.	A
www.han.nl.	A
filter2.spamengine.nl.	A
www.fotoview.nl.	AAAA
www.hetweer.nl.	AAAA
versatel.nl.	A
www.erodvd.nl.	A
zibb.nl.	MX
www.kittyhawk.nl.	A
mailrelay.planet.nl.	AAAA
puravitta.nl.	A
verkopen.marktplaats.nl.	A
sra.nl.	MX
mail.arkin.nl.	A
images6.images-speurders.nl.	A
forums.hababam.nl.	A
driebijlen.nl.	MX
ns4.firstfind.nl.	A
spaarselect.nl.	MX
stores.ebay.nl.	A
www.mnml.nl.	AAAA
schaatsen.blog.nl.	A
www.iphonesoftware.nl.	A
mx2.virtualmailsecurity.nl.	A
www.radio538.nl.	A
nlight.nl.	MX
static.autoblog.nl.	AAAA
b3ta.hnldesign.nl.	A
dnote.nl.	A
dexton.nl.	MX
rutter.nl.	MX
www.vlucht24.nl.	AAAA
www.humortv24.nl.	A
l1b.nl.	AAAA
www.onsoranje.nl.	A
nieuborg.nl.	A
www.zyxel.nl.	A
pissing.aff.mature.nl.	A
www.todayscelebs.nl.	A
rix0r.nl.	A
www.hispeed.nl.	A
www.puna.nl.	A
putt.nl.	MX
files.computertotaal.nl.	A
members.upc.nl.	AAAA
www.rnw.nl.	A
www.nieuwemobiel.nl.	AAAA
mx1.advocatenkantoorpalm.nl.	A
www.deltalloyd.nl.	A
onlinemapsforgames.nl.	A
www.lr.tudelft.nl.	A
ameydemarine.nl.	MX
van-uden.nl.	MX
uitert.nl.	MX
www.ndt.nl.	A
www.omoda.nl.	A
www.wielevert.nl.	A
www.expedia.nl.	AAAA
mail.vanarkel.nl.	A
wa.vodafone.nl.	A
us.rtl.nl.	A
www.withintemptation.hyves.nl.	A
reserved.transip.nl.	AAAA
mx.office2go.nl.	A
mail.dalsem.nl.	A
roundup-sss.gakijken.nl.	AAAA
oad.nl.	MX
www.inghist.nl.	A
www.alleentieners.nl.	A
autovisieblog.nl.	AAAA
mx1.speedxs.nl.	A
www.omroepzeeland.nl.	A
www.intermediair.nl.	AAAA
abp.nl.	MX
maildrop1.argewebhosting.nl.	A
ultimum.nl.	MX
its.ru.nl.	MX
msg5.avantage.nl.	A
xml.islive.nl.	AAAA
ads.wm-innovations.nl.	A
mx.moerstaal.nl.	A
etrn.interconnect.nl.	A
dhcp-077-249-128-143.chello.nl.	A
familie-kalkman.nl.	MX
denhaag.hyves.nl.	A
pbenu.nl.	MX
mx3.vpo.nl.	A
rijnijssel.nl.	MX
liof.nl.	MX
www.belletjes.nl.	A
www.bodylanguagedefilm.nl.	A
talenacademie.nl.	MX
www.reedbusiness.nl.	A
www.y1m.nl.	AAAA
www.modelautokampioen.nl.	AAAA
www.bndestem.nl.	AAAA
www.gameliner.nl.	A
productimages.wehkamp.nl.	A
svg.startpagina.nl.	AAAA
caiw.nl.	MX
xandernieuws.punt.nl.	A
home.iae.nl.	A
kennisnet.nl.	MX
www.audiblog.nl.	A
drechtsteden.nl.	MX
boktimg.nl.	AAAA
service.sanomamedia.nl.	A
www.top40.nl.	A
ns2.surfnet.nl.	A
mx1.rokscom.nl.	AAAA
fallback.clusternet.nl.	A
mail.flagellanten.nl.	A
weert.nl.	MX
www.ldsoft.nl.	AAAA
moremix.hyves.nl.	A
www.myhomeplanet.nl.	A
watersport.startpagina.nl.	A
mx2.sogmail.nl.	A
gamesolutions.efzeven.nl.	A
www.bigfishgames.nl.	A
www.bodyresource.nl.	AAAA
feeds.rijksoverheid.nl.	A
tele2.nl.	AAAA
ozexport.nl.	MX
taaltaal.nl.	A
mail.target-automotive.nl.	A
mail.planetpro.nl.	A
media.reclamefolder.nl.	A
www.nusport.nl.	A
mailcluster.introweb.nl.	A
mail.gateworks.nl.	A
mxdefender.prosolit.nl.	A
www.fsw.leidenuniv.nl.	A
forum.techzine.nl.	A
www.postnl.nl.	AAAA
a.mail.aspect-online.nl.	A
vliegen.idealo.nl.	A
wanadoo.nl.	MX
www.muziekweb.nl.	A
www.sexdate-delft.nl.	AAAA
www.totaaltv.nl.	AAAA
www.busign.nl.	A
gangsofcrime.speeleiland.nl.	AAAA
www.i-marco.nl.	A
cz6.clickzzs.nl.	AAAA
deltion.nl.	MX
www.daansamson.nl.	AAAA
drenthecollege.nl.	MX
mx2.siteview.nl.	A
sanko.nl.	AAAA
custom.islive.nl.	AAAA
service.upc.nl.	AAAA
www.postnl.nl.	A
mx2.cambrium.nl.	A
www.waste.nl.	A
jobsearch.monsterboard.nl.	A
alyssa.knuffelt.nl.	A
mail.advangeloven.nl.	A
mediapub.nl.	MX
www.loesje.nl.	A
optimum.unisys.nl.	MX
www.11steden.nl.	A
rads.tudelft.nl.	AAAA
xs4all.nl.	MX
erato.uvt.nl.	AAAA
www.kika.nl.	A
www.rtvutrecht.nl.	AAAA
www.iwriteiam.nl.	A
